group,team,g,pts,gf,ga,gd,group_rk,sim
A,Argentina,3,9,11,3,8,A1,1
A,Chile,3,6,5,4,1,A2,1
A,Peru,3,3,3,5,-2,A3,1
A,Canada,3,0,4,11,-7,A4,1
B,Mexico,3,7,5,2,3,B1,1
B,Jamaica,3,4,5,7,-2,B2,1
B,Venezuela,3,3,4,4,0,B3,1
B,Ecuador,3,3,4,5,-1,B4,1
C,United States,3,7,10,3,7,C1,1
C,Uruguay,3,7,9,2,7,C2,1
C,Panama,3,1,1,4,-3,C3,1
C,Bolivia,3,1,2,13,-11,C4,1
D,Brazil,3,7,6,1,5,D1,1
D,Colombia,3,4,3,2,1,D2,1
D,Costa Rica,3,3,3,6,-3,D3,1
D,Paraguay,3,3,2,5,-3,D4,1
A,Chile,3,5,7,6,1,A1,2
A,Argentina,3,4,3,2,1,A2,2
A,Canada,3,4,5,5,0,A3,2
A,Peru,3,2,5,7,-2,A4,2
B,Mexico,3,9,8,1,7,B1,2
B,Jamaica,3,4,2,2,0,B2,2
B,Ecuador,3,4,3,4,-1,B3,2
B,Venezuela,3,0,2,8,-6,B4,2
C,Uruguay,3,6,11,2,9,C1,2
C,United States,3,6,8,6,2,C2,2
C,Panama,3,4,4,4,0,C3,2
C,Bolivia,3,1,0,11,-11,C4,2
D,Brazil,3,9,7,0,7,D1,2
D,Colombia,3,4,3,4,-1,D2,2
D,Paraguay,3,3,1,5,-4,D3,2
D,Costa Rica,3,1,2,4,-2,D4,2
A,Chile,3,6,2,1,1,A1,3
A,Peru,3,6,2,3,-1,A2,3
A,Argentina,3,4,5,3,2,A3,3
A,Canada,3,1,2,4,-2,A4,3
B,Ecuador,3,7,7,2,5,B1,3
B,Mexico,3,7,4,2,2,B2,3
B,Venezuela,3,3,3,6,-3,B3,3
B,Jamaica,3,0,2,6,-4,B4,3
C,United States,3,9,7,1,6,C1,3
C,Uruguay,3,6,3,2,1,C2,3
C,Panama,3,3,2,3,-1,C3,3
C,Bolivia,3,0,1,7,-6,C4,3
D,Brazil,3,7,9,1,8,D1,3
D,Colombia,3,5,6,2,4,D2,3
D,Paraguay,3,2,1,3,-2,D3,3
D,Costa Rica,3,1,0,10,-10,D4,3
A,Argentina,3,7,9,2,7,A1,4
A,Chile,3,4,6,4,2,A2,4
A,Canada,3,4,4,7,-3,A3,4
A,Peru,3,1,1,7,-6,A4,4
B,Mexico,3,7,5,0,5,B1,4
B,Venezuela,3,4,5,5,0,B2,4
B,Ecuador,3,3,4,6,-2,B3,4
B,Jamaica,3,3,4,7,-3,B4,4
C,United States,3,9,6,0,6,C1,4
C,Panama,3,6,5,5,0,C2,4
C,Uruguay,3,1,3,5,-2,C3,4
C,Bolivia,3,1,3,7,-4,C4,4
D,Brazil,3,7,6,2,4,D1,4
D,Paraguay,3,4,1,3,-2,D2,4
D,Colombia,3,3,2,2,0,D3,4
D,Costa Rica,3,1,2,4,-2,D4,4
A,Peru,3,9,7,1,6,A1,5
A,Argentina,3,4,5,2,3,A2,5
A,Canada,3,3,2,7,-5,A3,5
A,Chile,3,1,1,5,-4,A4,5
B,Mexico,3,7,5,1,4,B1,5
B,Venezuela,3,4,5,4,1,B2,5
B,Jamaica,3,3,3,7,-4,B3,5
B,Ecuador,3,2,2,3,-1,B4,5
C,Bolivia,3,6,4,3,1,C1,5
C,Uruguay,3,4,5,5,0,C2,5
C,United States,3,4,2,2,0,C3,5
C,Panama,3,2,5,6,-1,C4,5
D,Brazil,3,6,5,1,4,D1,5
D,Paraguay,3,6,4,2,2,D2,5
D,Colombia,3,4,3,3,0,D3,5
D,Costa Rica,3,1,2,8,-6,D4,5
A,Canada,3,7,5,2,3,A1,6
A,Chile,3,6,4,2,2,A2,6
A,Argentina,3,4,4,3,1,A3,6
A,Peru,3,0,1,7,-6,A4,6
B,Ecuador,3,6,8,5,3,B1,6
B,Venezuela,3,5,4,3,1,B2,6
B,Mexico,3,4,3,3,0,B3,6
B,Jamaica,3,1,1,5,-4,B4,6
C,United States,3,6,5,2,3,C1,6
C,Panama,3,6,3,3,0,C2,6
C,Uruguay,3,3,4,5,-1,C3,6
C,Bolivia,3,3,3,5,-2,C4,6
D,Paraguay,3,6,3,2,1,D1,6
D,Colombia,3,5,2,1,1,D2,6
D,Brazil,3,4,1,1,0,D3,6
D,Costa Rica,3,1,0,2,-2,D4,6
A,Chile,3,6,6,4,2,A1,7
A,Peru,3,5,2,0,2,A2,7
A,Canada,3,4,1,3,-2,A3,7
A,Argentina,3,1,2,4,-2,A4,7
B,Ecuador,3,9,6,2,4,B1,7
B,Mexico,3,3,5,6,-1,B2,7
B,Jamaica,3,3,3,4,-1,B3,7
B,Venezuela,3,3,3,5,-2,B4,7
C,Uruguay,3,9,6,0,6,C1,7
C,United States,3,6,5,3,2,C2,7
C,Panama,3,3,4,7,-3,C3,7
C,Bolivia,3,0,2,7,-5,C4,7
D,Brazil,3,9,9,2,7,D1,7
D,Colombia,3,4,3,3,0,D2,7
D,Costa Rica,3,2,2,6,-4,D3,7
D,Paraguay,3,1,5,8,-3,D4,7
A,Argentina,3,9,7,0,7,A1,8
A,Chile,3,6,3,1,2,A2,8
A,Canada,3,3,2,5,-3,A3,8
A,Peru,3,0,1,7,-6,A4,8
B,Mexico,3,6,6,4,2,B1,8
B,Ecuador,3,6,5,4,1,B2,8
B,Venezuela,3,4,4,4,0,B3,8
B,Jamaica,3,1,2,5,-3,B4,8
C,Uruguay,3,7,9,4,5,C1,8
C,United States,3,4,6,3,3,C2,8
C,Panama,3,4,5,7,-2,C3,8
C,Bolivia,3,1,5,11,-6,C4,8
D,Brazil,3,9,7,2,5,D1,8
D,Paraguay,3,4,3,2,1,D2,8
D,Colombia,3,2,1,4,-3,D3,8
D,Costa Rica,3,1,2,5,-3,D4,8
A,Argentina,3,7,4,1,3,A1,9
A,Chile,3,6,5,3,2,A2,9
A,Peru,3,4,3,3,0,A3,9
A,Canada,3,0,3,8,-5,A4,9
B,Venezuela,3,7,4,1,3,B1,9
B,Mexico,3,7,4,2,2,B2,9
B,Ecuador,3,1,2,4,-2,B3,9
B,Jamaica,3,1,1,4,-3,B4,9
C,United States,3,7,7,2,5,C1,9
C,Bolivia,3,4,5,5,0,C2,9
C,Panama,3,4,2,3,-1,C3,9
C,Uruguay,3,1,3,7,-4,C4,9
D,Colombia,3,7,5,3,2,D1,9
D,Brazil,3,4,9,3,6,D2,9
D,Costa Rica,3,3,2,9,-7,D3,9
D,Paraguay,3,2,4,5,-1,D4,9
A,Argentina,3,9,7,0,7,A1,10
A,Canada,3,6,3,4,-1,A2,10
A,Chile,3,3,3,4,-1,A3,10
A,Peru,3,0,0,5,-5,A4,10
B,Ecuador,3,5,4,2,2,B1,10
B,Mexico,3,5,3,2,1,B2,10
B,Venezuela,3,5,2,1,1,B3,10
B,Jamaica,3,0,1,5,-4,B4,10
C,United States,3,7,7,2,5,C1,10
C,Uruguay,3,7,6,2,4,C2,10
C,Bolivia,3,3,2,7,-5,C3,10
C,Panama,3,0,1,5,-4,C4,10
D,Colombia,3,6,9,3,6,D1,10
D,Brazil,3,4,1,1,0,D2,10
D,Paraguay,3,4,2,6,-4,D3,10
D,Costa Rica,3,3,3,5,-2,D4,10
A,Argentina,3,7,5,2,3,A1,11
A,Canada,3,4,5,5,0,A2,11
A,Chile,3,4,4,5,-1,A3,11
A,Peru,3,1,2,4,-2,A4,11
B,Mexico,3,5,8,4,4,B1,11
B,Venezuela,3,5,8,4,4,B2,11
B,Ecuador,3,4,6,8,-2,B3,11
B,Jamaica,3,1,2,8,-6,B4,11
C,United States,3,9,9,2,7,C1,11
C,Uruguay,3,4,6,8,-2,C2,11
C,Bolivia,3,2,4,5,-1,C3,11
C,Panama,3,1,2,6,-4,C4,11
D,Costa Rica,3,6,3,7,-4,D1,11
D,Brazil,3,4,6,3,3,D2,11
D,Colombia,3,4,6,4,2,D3,11
D,Paraguay,3,2,2,3,-1,D4,11
A,Argentina,3,7,6,2,4,A1,12
A,Canada,3,6,4,3,1,A2,12
A,Peru,3,4,2,2,0,A3,12
A,Chile,3,0,1,6,-5,A4,12
B,Mexico,3,7,6,3,3,B1,12
B,Ecuador,3,6,3,2,1,B2,12
B,Venezuela,3,2,3,4,-1,B3,12
B,Jamaica,3,1,2,5,-3,B4,12
C,Panama,3,9,7,4,3,C1,12
C,United States,3,6,4,2,2,C2,12
C,Uruguay,3,3,6,5,1,C3,12
C,Bolivia,3,0,6,12,-6,C4,12
D,Brazil,3,9,4,1,3,D1,12
D,Paraguay,3,3,3,2,1,D2,12
D,Colombia,3,3,1,2,-1,D3,12
D,Costa Rica,3,3,2,5,-3,D4,12
A,Chile,3,7,3,1,2,A1,13
A,Argentina,3,6,5,1,4,A2,13
A,Canada,3,3,1,4,-3,A3,13
A,Peru,3,1,1,4,-3,A4,13
B,Ecuador,3,7,8,3,5,B1,13
B,Venezuela,3,4,4,3,1,B2,13
B,Mexico,3,3,2,4,-2,B3,13
B,Jamaica,3,3,1,5,-4,B4,13
C,Panama,3,6,5,2,3,C1,13
C,Uruguay,3,6,4,3,1,C2,13
C,United States,3,4,2,1,1,C3,13
C,Bolivia,3,1,1,6,-5,C4,13
D,Brazil,3,7,5,0,5,D1,13
D,Colombia,3,5,1,0,1,D2,13
D,Costa Rica,3,2,1,5,-4,D3,13
D,Paraguay,3,1,1,3,-2,D4,13
A,Argentina,3,6,6,5,1,A1,14
A,Chile,3,4,3,2,1,A2,14
A,Peru,3,4,4,4,0,A3,14
A,Canada,3,2,2,4,-2,A4,14
B,Mexico,3,7,6,1,5,B1,14
B,Ecuador,3,7,5,1,4,B2,14
B,Venezuela,3,3,2,5,-3,B3,14
B,Jamaica,3,0,0,6,-6,B4,14
C,United States,3,9,5,1,4,C1,14
C,Bolivia,3,4,4,5,-1,C2,14
C,Uruguay,3,2,5,6,-1,C3,14
C,Panama,3,1,3,5,-2,C4,14
D,Colombia,3,7,3,1,2,D1,14
D,Brazil,3,6,4,1,3,D2,14
D,Costa Rica,3,2,0,1,-1,D3,14
D,Paraguay,3,1,1,5,-4,D4,14
A,Argentina,3,9,7,1,6,A1,15
A,Peru,3,2,2,3,-1,A2,15
A,Chile,3,2,4,6,-2,A3,15
A,Canada,3,2,3,6,-3,A4,15
B,Mexico,3,9,7,2,5,B1,15
B,Ecuador,3,6,8,8,0,B2,15
B,Jamaica,3,3,5,7,-2,B3,15
B,Venezuela,3,0,2,5,-3,B4,15
C,Bolivia,3,5,7,5,2,C1,15
C,United States,3,4,7,6,1,C2,15
C,Panama,3,4,3,4,-1,C3,15
C,Uruguay,3,2,6,8,-2,C4,15
D,Brazil,3,9,5,1,4,D1,15
D,Colombia,3,4,4,3,1,D2,15
D,Costa Rica,3,2,2,4,-2,D3,15
D,Paraguay,3,1,1,4,-3,D4,15
A,Argentina,3,7,6,2,4,A1,16
A,Canada,3,6,3,4,-1,A2,16
A,Chile,3,2,1,2,-1,A3,16
A,Peru,3,1,0,2,-2,A4,16
B,Mexico,3,9,6,1,5,B1,16
B,Ecuador,3,4,5,4,1,B2,16
B,Venezuela,3,4,2,3,-1,B3,16
B,Jamaica,3,0,1,6,-5,B4,16
C,Uruguay,3,6,10,4,6,C1,16
C,Bolivia,3,6,7,6,1,C2,16
C,United States,3,6,6,5,1,C3,16
C,Panama,3,0,3,11,-8,C4,16
D,Brazil,3,7,3,0,3,D1,16
D,Colombia,3,6,6,2,4,D2,16
D,Costa Rica,3,3,3,6,-3,D3,16
D,Paraguay,3,1,0,4,-4,D4,16
A,Argentina,3,7,4,0,4,A1,17
A,Chile,3,6,3,2,1,A2,17
A,Canada,3,4,2,2,0,A3,17
A,Peru,3,0,1,6,-5,A4,17
B,Mexico,3,9,9,2,7,B1,17
B,Ecuador,3,4,7,5,2,B2,17
B,Venezuela,3,4,1,1,0,B3,17
B,Jamaica,3,0,2,11,-9,B4,17
C,United States,3,7,5,1,4,C1,17
C,Uruguay,3,5,5,2,3,C2,17
C,Panama,3,2,1,2,-1,C3,17
C,Bolivia,3,1,2,8,-6,C4,17
D,Paraguay,3,7,4,2,2,D1,17
D,Brazil,3,7,3,1,2,D2,17
D,Colombia,3,3,1,2,-1,D3,17
D,Costa Rica,3,0,1,4,-3,D4,17
A,Argentina,3,9,8,1,7,A1,18
A,Chile,3,4,2,3,-1,A2,18
A,Peru,3,3,2,5,-3,A3,18
A,Canada,3,1,1,4,-3,A4,18
B,Ecuador,3,7,3,0,3,B1,18
B,Mexico,3,6,7,3,4,B2,18
B,Venezuela,3,3,3,5,-2,B3,18
B,Jamaica,3,1,0,5,-5,B4,18
C,United States,3,9,8,3,5,C1,18
C,Uruguay,3,6,6,3,3,C2,18
C,Panama,3,1,1,4,-3,C3,18
C,Bolivia,3,1,1,6,-5,C4,18
D,Brazil,3,6,3,1,2,D1,18
D,Colombia,3,4,5,3,2,D2,18
D,Paraguay,3,4,3,3,0,D3,18
D,Costa Rica,3,3,2,6,-4,D4,18
A,Argentina,3,7,8,2,6,A1,19
A,Peru,3,5,5,3,2,A2,19
A,Canada,3,2,4,9,-5,A3,19
A,Chile,3,1,1,4,-3,A4,19
B,Venezuela,3,6,5,3,2,B1,19
B,Mexico,3,5,4,1,3,B2,19
B,Ecuador,3,4,2,4,-2,B3,19
B,Jamaica,3,1,0,3,-3,B4,19
C,United States,3,9,4,0,4,C1,19
C,Uruguay,3,6,5,4,1,C2,19
C,Bolivia,3,3,3,5,-2,C3,19
C,Panama,3,0,3,6,-3,C4,19
D,Brazil,3,7,10,2,8,D1,19
D,Costa Rica,3,4,1,5,-4,D2,19
D,Paraguay,3,2,3,4,-1,D3,19
D,Colombia,3,2,1,4,-3,D4,19
A,Chile,3,9,6,2,4,A1,20
A,Argentina,3,6,6,3,3,A2,20
A,Canada,3,3,5,6,-1,A3,20
A,Peru,3,0,2,8,-6,A4,20
B,Ecuador,3,6,7,3,4,B1,20
B,Mexico,3,6,3,3,0,B2,20
B,Venezuela,3,4,4,5,-1,B3,20
B,Jamaica,3,1,3,6,-3,B4,20
C,United States,3,7,4,2,2,C1,20
C,Panama,3,5,1,0,1,C2,20
C,Uruguay,3,4,5,3,2,C3,20
C,Bolivia,3,0,0,5,-5,C4,20
D,Brazil,3,9,7,3,4,D1,20
D,Costa Rica,3,4,3,3,0,D2,20
D,Paraguay,3,3,3,4,-1,D3,20
D,Colombia,3,1,2,5,-3,D4,20
A,Peru,3,6,5,3,2,A1,21
A,Argentina,3,6,4,4,0,A2,21
A,Canada,3,3,6,6,0,A3,21
A,Chile,3,3,3,5,-2,A4,21
B,Mexico,3,7,6,1,5,B1,21
B,Venezuela,3,5,4,3,1,B2,21
B,Ecuador,3,3,5,4,1,B3,21
B,Jamaica,3,1,1,8,-7,B4,21
C,Uruguay,3,7,7,2,5,C1,21
C,United States,3,5,4,2,2,C2,21
C,Panama,3,4,6,5,1,C3,21
C,Bolivia,3,0,3,11,-8,C4,21
D,Colombia,3,5,5,2,3,D1,21
D,Paraguay,3,5,4,3,1,D2,21
D,Brazil,3,5,3,2,1,D3,21
D,Costa Rica,3,0,1,6,-5,D4,21
A,Argentina,3,9,9,2,7,A1,22
A,Canada,3,6,5,6,-1,A2,22
A,Chile,3,1,1,3,-2,A3,22
A,Peru,3,1,3,7,-4,A4,22
B,Mexico,3,9,5,2,3,B1,22
B,Ecuador,3,6,3,2,1,B2,22
B,Venezuela,3,3,2,3,-1,B3,22
B,Jamaica,3,0,2,5,-3,B4,22
C,United States,3,7,8,4,4,C1,22
C,Uruguay,3,4,4,4,0,C2,22
C,Bolivia,3,2,4,6,-2,C3,22
C,Panama,3,2,4,6,-2,C4,22
D,Colombia,3,7,6,1,5,D1,22
D,Costa Rica,3,4,3,4,-1,D2,22
D,Paraguay,3,3,3,6,-3,D3,22
D,Brazil,3,2,1,2,-1,D4,22
A,Argentina,3,7,6,1,5,A1,23
A,Peru,3,6,4,2,2,A2,23
A,Chile,3,3,5,5,0,A3,23
A,Canada,3,1,0,7,-7,A4,23
B,Ecuador,3,7,4,2,2,B1,23
B,Jamaica,3,4,3,2,1,B2,23
B,Mexico,3,4,5,5,0,B3,23
B,Venezuela,3,1,3,6,-3,B4,23
C,Uruguay,3,7,7,2,5,C1,23
C,United States,3,3,4,4,0,C2,23
C,Bolivia,3,2,3,5,-2,C3,23
C,Panama,3,2,1,4,-3,C4,23
D,Brazil,3,7,6,1,5,D1,23
D,Costa Rica,3,5,3,1,2,D2,23
D,Colombia,3,3,3,6,-3,D3,23
D,Paraguay,3,1,2,6,-4,D4,23
A,Argentina,3,9,9,1,8,A1,24
A,Peru,3,4,3,5,-2,A2,24
A,Canada,3,2,1,5,-4,A3,24
A,Chile,3,1,2,4,-2,A4,24
B,Mexico,3,9,6,0,6,B1,24
B,Ecuador,3,3,3,4,-1,B2,24
B,Venezuela,3,3,2,4,-2,B3,24
B,Jamaica,3,3,1,4,-3,B4,24
C,United States,3,7,6,2,4,C1,24
C,Uruguay,3,7,5,1,4,C2,24
C,Bolivia,3,1,1,4,-3,C3,24
C,Panama,3,1,2,7,-5,C4,24
D,Colombia,3,9,7,1,6,D1,24
D,Brazil,3,6,8,4,4,D2,24
D,Costa Rica,3,1,2,6,-4,D3,24
D,Paraguay,3,1,3,9,-6,D4,24
A,Argentina,3,9,10,1,9,A1,25
A,Chile,3,6,4,4,0,A2,25
A,Peru,3,3,3,6,-3,A3,25
A,Canada,3,0,0,6,-6,A4,25
B,Mexico,3,5,2,1,1,B1,25
B,Venezuela,3,4,3,2,1,B2,25
B,Ecuador,3,4,4,5,-1,B3,25
B,Jamaica,3,2,3,4,-1,B4,25
C,Uruguay,3,7,2,0,2,C1,25
C,Bolivia,3,4,2,1,1,C2,25
C,Panama,3,3,2,3,-1,C3,25
C,United States,3,2,0,2,-2,C4,25
D,Paraguay,3,7,7,4,3,D1,25
D,Brazil,3,7,6,3,3,D2,25
D,Colombia,3,1,0,2,-2,D3,25
D,Costa Rica,3,1,1,5,-4,D4,25
A,Argentina,3,7,4,0,4,A1,26
A,Canada,3,6,3,3,0,A2,26
A,Chile,3,2,1,3,-2,A3,26
A,Peru,3,1,1,3,-2,A4,26
B,Ecuador,3,9,7,3,4,B1,26
B,Mexico,3,6,6,4,2,B2,26
B,Jamaica,3,3,4,6,-2,B3,26
B,Venezuela,3,0,3,7,-4,B4,26
C,Uruguay,3,9,8,1,7,C1,26
C,United States,3,6,5,2,3,C2,26
C,Panama,3,3,1,7,-6,C3,26
C,Bolivia,3,0,0,4,-4,C4,26
D,Costa Rica,3,7,6,3,3,D1,26
D,Brazil,3,6,4,3,1,D2,26
D,Colombia,3,4,5,5,0,D3,26
D,Paraguay,3,0,3,7,-4,D4,26
A,Argentina,3,9,7,2,5,A1,27
A,Chile,3,6,5,2,3,A2,27
A,Canada,3,1,4,8,-4,A3,27
A,Peru,3,1,1,5,-4,A4,27
B,Mexico,3,7,8,0,8,B1,27
B,Ecuador,3,7,4,1,3,B2,27
B,Venezuela,3,1,1,3,-2,B3,27
B,Jamaica,3,1,2,11,-9,B4,27
C,Uruguay,3,7,5,2,3,C1,27
C,United States,3,6,4,2,2,C2,27
C,Panama,3,3,1,3,-2,C3,27
C,Bolivia,3,1,1,4,-3,C4,27
D,Brazil,3,7,5,1,4,D1,27
D,Paraguay,3,5,5,4,1,D2,27
D,Costa Rica,3,2,1,4,-3,D3,27
D,Colombia,3,1,2,4,-2,D4,27
A,Argentina,3,9,6,0,6,A1,28
A,Chile,3,4,3,4,-1,A2,28
A,Peru,3,4,3,4,-1,A3,28
A,Canada,3,0,1,5,-4,A4,28
B,Mexico,3,6,3,3,0,B1,28
B,Venezuela,3,4,3,2,1,B2,28
B,Jamaica,3,4,3,3,0,B3,28
B,Ecuador,3,3,3,4,-1,B4,28
C,Uruguay,3,5,6,4,2,C1,28
C,United States,3,5,2,0,2,C2,28
C,Bolivia,3,3,4,6,-2,C3,28
C,Panama,3,2,2,4,-2,C4,28
D,Brazil,3,9,11,0,11,D1,28
D,Colombia,3,4,4,6,-2,D2,28
D,Costa Rica,3,3,2,6,-4,D3,28
D,Paraguay,3,1,3,8,-5,D4,28
A,Canada,3,7,5,0,5,A1,29
A,Chile,3,4,3,2,1,A2,29
A,Peru,3,3,3,7,-4,A3,29
A,Argentina,3,2,1,3,-2,A4,29
B,Mexico,3,7,6,1,5,B1,29
B,Venezuela,3,3,3,3,0,B2,29
B,Ecuador,3,2,1,2,-1,B3,29
B,Jamaica,3,2,3,7,-4,B4,29
C,United States,3,9,9,1,8,C1,29
C,Uruguay,3,6,8,4,4,C2,29
C,Bolivia,3,3,2,9,-7,C3,29
C,Panama,3,0,1,6,-5,C4,29
D,Brazil,3,7,9,1,8,D1,29
D,Colombia,3,5,1,0,1,D2,29
D,Costa Rica,3,2,2,7,-5,D3,29
D,Paraguay,3,1,3,7,-4,D4,29
A,Chile,3,9,6,3,3,A1,30
A,Argentina,3,6,5,1,4,A2,30
A,Canada,3,1,3,6,-3,A3,30
A,Peru,3,1,0,4,-4,A4,30
B,Mexico,3,6,6,3,3,B1,30
B,Jamaica,3,6,3,3,0,B2,30
B,Ecuador,3,3,6,6,0,B3,30
B,Venezuela,3,3,3,6,-3,B4,30
C,Uruguay,3,5,5,2,3,C1,30
C,United States,3,4,5,3,2,C2,30
C,Bolivia,3,4,4,4,0,C3,30
C,Panama,3,3,2,7,-5,C4,30
D,Colombia,3,5,7,3,4,D1,30
D,Brazil,3,5,4,3,1,D2,30
D,Costa Rica,3,3,3,3,0,D3,30
D,Paraguay,3,1,1,6,-5,D4,30
A,Peru,3,6,6,2,4,A1,31
A,Argentina,3,5,5,4,1,A2,31
A,Chile,3,4,4,4,0,A3,31
A,Canada,3,1,3,8,-5,A4,31
B,Ecuador,3,5,2,0,2,B1,31
B,Jamaica,3,5,3,2,1,B2,31
B,Mexico,3,2,1,2,-1,B3,31
B,Venezuela,3,2,1,3,-2,B4,31
C,Uruguay,3,9,4,0,4,C1,31
C,Panama,3,4,3,2,1,C2,31
C,Bolivia,3,3,2,4,-2,C3,31
C,United States,3,1,2,5,-3,C4,31
D,Brazil,3,7,6,4,2,D1,31
D,Colombia,3,6,4,3,1,D2,31
D,Costa Rica,3,3,5,5,0,D3,31
D,Paraguay,3,1,1,4,-3,D4,31
A,Argentina,3,5,3,1,2,A1,32
A,Chile,3,5,3,1,2,A2,32
A,Peru,3,4,3,4,-1,A3,32
A,Canada,3,1,2,5,-3,A4,32
B,Mexico,3,7,5,1,4,B1,32
B,Ecuador,3,5,4,2,2,B2,32
B,Venezuela,3,4,2,3,-1,B3,32
B,Jamaica,3,0,2,7,-5,B4,32
C,Uruguay,3,6,2,2,0,C1,32
C,Panama,3,6,5,6,-1,C2,32
C,United States,3,4,6,2,4,C3,32
C,Bolivia,3,1,0,3,-3,C4,32
D,Brazil,3,7,7,1,6,D1,32
D,Colombia,3,3,1,1,0,D2,32
D,Costa Rica,3,2,2,3,-1,D3,32
D,Paraguay,3,2,2,7,-5,D4,32
A,Argentina,3,5,6,4,2,A1,33
A,Chile,3,4,6,7,-1,A2,33
A,Peru,3,3,3,3,0,A3,33
A,Canada,3,2,6,7,-1,A4,33
B,Mexico,3,9,6,1,5,B1,33
B,Ecuador,3,6,5,2,3,B2,33
B,Jamaica,3,3,1,5,-4,B3,33
B,Venezuela,3,0,0,4,-4,B4,33
C,Uruguay,3,7,5,0,5,C1,33
C,United States,3,7,7,4,3,C2,33
C,Panama,3,1,3,6,-3,C3,33
C,Bolivia,3,1,3,8,-5,C4,33
D,Brazil,3,7,10,1,9,D1,33
D,Colombia,3,4,5,7,-2,D2,33
D,Costa Rica,3,3,3,3,0,D3,33
D,Paraguay,3,1,3,10,-7,D4,33
A,Argentina,3,9,8,1,7,A1,34
A,Canada,3,3,3,3,0,A2,34
A,Chile,3,3,3,4,-1,A3,34
A,Peru,3,3,3,9,-6,A4,34
B,Ecuador,3,6,2,2,0,B1,34
B,Venezuela,3,4,2,2,0,B2,34
B,Jamaica,3,4,2,3,-1,B3,34
B,Mexico,3,3,4,3,1,B4,34
C,United States,3,7,7,4,3,C1,34
C,Uruguay,3,4,5,5,0,C2,34
C,Bolivia,3,2,6,7,-1,C3,34
C,Panama,3,2,4,6,-2,C4,34
D,Brazil,3,9,10,1,9,D1,34
D,Colombia,3,4,3,3,0,D2,34
D,Costa Rica,3,4,3,8,-5,D3,34
D,Paraguay,3,0,1,5,-4,D4,34
A,Argentina,3,9,8,1,7,A1,35
A,Chile,3,4,8,7,1,A2,35
A,Peru,3,2,2,4,-2,A3,35
A,Canada,3,1,3,9,-6,A4,35
B,Venezuela,3,6,8,4,4,B1,35
B,Mexico,3,6,2,1,1,B2,35
B,Ecuador,3,3,3,3,0,B3,35
B,Jamaica,3,3,2,7,-5,B4,35
C,Uruguay,3,4,5,3,2,C1,35
C,United States,3,4,2,2,0,C2,35
C,Bolivia,3,4,1,3,-2,C3,35
C,Panama,3,3,1,1,0,C4,35
D,Brazil,3,7,9,1,8,D1,35
D,Paraguay,3,6,2,6,-4,D2,35
D,Colombia,3,3,1,3,-2,D3,35
D,Costa Rica,3,1,1,3,-2,D4,35
A,Argentina,3,7,7,0,7,A1,36
A,Canada,3,4,2,4,-2,A2,36
A,Chile,3,4,1,3,-2,A3,36
A,Peru,3,1,0,3,-3,A4,36
B,Venezuela,3,9,8,1,7,B1,36
B,Mexico,3,4,2,3,-1,B2,36
B,Ecuador,3,3,4,5,-1,B3,36
B,Jamaica,3,1,1,6,-5,B4,36
C,Uruguay,3,9,7,2,5,C1,36
C,Bolivia,3,4,6,5,1,C2,36
C,United States,3,2,4,6,-2,C3,36
C,Panama,3,1,2,6,-4,C4,36
D,Brazil,3,7,7,3,4,D1,36
D,Paraguay,3,6,6,4,2,D2,36
D,Colombia,3,4,6,5,1,D3,36
D,Costa Rica,3,0,1,8,-7,D4,36
A,Chile,3,7,5,1,4,A1,37
A,Argentina,3,7,3,0,3,A2,37
A,Peru,3,1,0,3,-3,A3,37
A,Canada,3,1,1,5,-4,A4,37
B,Jamaica,3,6,4,4,0,B1,37
B,Ecuador,3,4,4,3,1,B2,37
B,Mexico,3,4,4,3,1,B3,37
B,Venezuela,3,3,3,5,-2,B4,37
C,Panama,3,7,8,3,5,C1,37
C,Uruguay,3,7,7,3,4,C2,37
C,Bolivia,3,1,3,5,-2,C3,37
C,United States,3,1,1,8,-7,C4,37
D,Colombia,3,7,3,0,3,D1,37
D,Paraguay,3,6,3,2,1,D2,37
D,Brazil,3,3,4,4,0,D3,37
D,Costa Rica,3,1,1,5,-4,D4,37
A,Argentina,3,9,5,0,5,A1,38
A,Chile,3,6,7,6,1,A2,38
A,Peru,3,3,6,6,0,A3,38
A,Canada,3,0,3,9,-6,A4,38
B,Ecuador,3,7,4,1,3,B1,38
B,Mexico,3,4,5,3,2,B2,38
B,Venezuela,3,4,4,3,1,B3,38
B,Jamaica,3,1,2,8,-6,B4,38
C,United States,3,7,7,3,4,C1,38
C,Uruguay,3,5,9,3,6,C2,38
C,Panama,3,2,2,4,-2,C3,38
C,Bolivia,3,1,2,10,-8,C4,38
D,Paraguay,3,7,2,0,2,D1,38
D,Brazil,3,6,3,1,2,D2,38
D,Colombia,3,3,2,2,0,D3,38
D,Costa Rica,3,1,0,4,-4,D4,38
A,Chile,3,7,5,2,3,A1,39
A,Argentina,3,6,8,3,5,A2,39
A,Peru,3,2,2,6,-4,A3,39
A,Canada,3,1,2,6,-4,A4,39
B,Mexico,3,7,4,1,3,B1,39
B,Ecuador,3,6,6,1,5,B2,39
B,Venezuela,3,4,6,5,1,B3,39
B,Jamaica,3,0,3,12,-9,B4,39
C,Uruguay,3,6,4,4,0,C1,39
C,United States,3,4,2,1,1,C2,39
C,Panama,3,4,4,4,0,C3,39
C,Bolivia,3,2,3,4,-1,C4,39
D,Brazil,3,7,4,1,3,D1,39
D,Colombia,3,5,5,3,2,D2,39
D,Costa Rica,3,3,3,5,-2,D3,39
D,Paraguay,3,1,1,4,-3,D4,39
A,Argentina,3,9,10,2,8,A1,40
A,Peru,3,4,1,2,-1,A2,40
A,Canada,3,4,2,5,-3,A3,40
A,Chile,3,0,3,7,-4,A4,40
B,Venezuela,3,7,6,1,5,B1,40
B,Ecuador,3,6,5,4,1,B2,40
B,Mexico,3,4,2,3,-1,B3,40
B,Jamaica,3,0,2,7,-5,B4,40
C,United States,3,9,6,2,4,C1,40
C,Uruguay,3,4,3,2,1,C2,40
C,Bolivia,3,3,2,5,-3,C3,40
C,Panama,3,1,2,4,-2,C4,40
D,Paraguay,3,6,4,3,1,D1,40
D,Brazil,3,4,3,2,1,D2,40
D,Costa Rica,3,4,2,2,0,D3,40
D,Colombia,3,2,1,3,-2,D4,40
A,Argentina,3,4,6,3,3,A1,41
A,Peru,3,4,3,3,0,A2,41
A,Chile,3,4,2,2,0,A3,41
A,Canada,3,4,2,5,-3,A4,41
B,Venezuela,3,5,4,3,1,B1,41
B,Mexico,3,4,4,4,0,B2,41
B,Jamaica,3,3,2,2,0,B3,41
B,Ecuador,3,2,4,5,-1,B4,41
C,United States,3,9,14,5,9,C1,41
C,Uruguay,3,6,6,4,2,C2,41
C,Bolivia,3,1,2,6,-4,C3,41
C,Panama,3,1,4,11,-7,C4,41
D,Colombia,3,7,5,1,4,D1,41
D,Brazil,3,6,5,5,0,D2,41
D,Paraguay,3,4,4,3,1,D3,41
D,Costa Rica,3,0,4,9,-5,D4,41
A,Peru,3,4,5,4,1,A1,42
A,Argentina,3,4,4,3,1,A2,42
A,Chile,3,4,3,5,-2,A3,42
A,Canada,3,3,4,4,0,A4,42
B,Ecuador,3,7,6,1,5,B1,42
B,Mexico,3,6,7,3,4,B2,42
B,Venezuela,3,4,4,4,0,B3,42
B,Jamaica,3,0,2,11,-9,B4,42
C,Uruguay,3,9,5,1,4,C1,42
C,United States,3,6,6,3,3,C2,42
C,Bolivia,3,3,2,6,-4,C3,42
C,Panama,3,0,0,3,-3,C4,42
D,Colombia,3,9,4,1,3,D1,42
D,Brazil,3,6,8,2,6,D2,42
D,Paraguay,3,3,4,5,-1,D3,42
D,Costa Rica,3,0,1,9,-8,D4,42
A,Argentina,3,6,5,4,1,A1,43
A,Chile,3,6,4,3,1,A2,43
A,Peru,3,6,4,3,1,A3,43
A,Canada,3,0,3,6,-3,A4,43
B,Mexico,3,6,7,2,5,B1,43
B,Ecuador,3,6,3,2,1,B2,43
B,Jamaica,3,3,2,5,-3,B3,43
B,Venezuela,3,3,1,4,-3,B4,43
C,Uruguay,3,9,6,1,5,C1,43
C,Panama,3,4,4,4,0,C2,43
C,United States,3,4,2,3,-1,C3,43
C,Bolivia,3,0,3,7,-4,C4,43
D,Brazil,3,9,13,0,13,D1,43
D,Colombia,3,6,2,1,1,D2,43
D,Paraguay,3,3,2,5,-3,D3,43
D,Costa Rica,3,0,1,12,-11,D4,43
A,Peru,3,9,8,1,7,A1,44
A,Argentina,3,6,7,3,4,A2,44
A,Chile,3,3,3,5,-2,A3,44
A,Canada,3,0,0,9,-9,A4,44
B,Venezuela,3,7,6,3,3,B1,44
B,Ecuador,3,6,6,4,2,B2,44
B,Mexico,3,4,4,2,2,B3,44
B,Jamaica,3,0,1,8,-7,B4,44
C,Uruguay,3,7,6,3,3,C1,44
C,Bolivia,3,6,6,4,2,C2,44
C,United States,3,3,4,5,-1,C3,44
C,Panama,3,1,1,5,-4,C4,44
D,Brazil,3,7,9,1,8,D1,44
D,Costa Rica,3,6,6,9,-3,D2,44
D,Colombia,3,4,4,2,2,D3,44
D,Paraguay,3,0,2,9,-7,D4,44
A,Argentina,3,7,4,1,3,A1,45
A,Chile,3,7,3,0,3,A2,45
A,Canada,3,3,2,4,-2,A3,45
A,Peru,3,0,2,6,-4,A4,45
B,Mexico,3,9,9,1,8,B1,45
B,Ecuador,3,6,5,5,0,B2,45
B,Venezuela,3,3,4,5,-1,B3,45
B,Jamaica,3,0,2,9,-7,B4,45
C,United States,3,6,6,3,3,C1,45
C,Uruguay,3,6,6,3,3,C2,45
C,Bolivia,3,6,4,4,0,C3,45
C,Panama,3,0,0,6,-6,C4,45
D,Brazil,3,9,8,1,7,D1,45
D,Costa Rica,3,4,2,2,0,D2,45
D,Colombia,3,3,2,4,-2,D3,45
D,Paraguay,3,1,0,5,-5,D4,45
A,Argentina,3,5,6,1,5,A1,46
A,Chile,3,4,5,2,3,A2,46
A,Peru,3,4,2,5,-3,A3,46
A,Canada,3,3,2,7,-5,A4,46
B,Ecuador,3,6,9,5,4,B1,46
B,Mexico,3,6,3,1,2,B2,46
B,Jamaica,3,3,4,7,-3,B3,46
B,Venezuela,3,3,4,7,-3,B4,46
C,Uruguay,3,7,7,4,3,C1,46
C,Bolivia,3,6,3,3,0,C2,46
C,United States,3,2,3,4,-1,C3,46
C,Panama,3,1,2,4,-2,C4,46
D,Brazil,3,6,3,2,1,D1,46
D,Paraguay,3,5,2,1,1,D2,46
D,Colombia,3,4,4,2,2,D3,46
D,Costa Rica,3,1,1,5,-4,D4,46
A,Argentina,3,7,4,1,3,A1,47
A,Peru,3,7,2,0,2,A2,47
A,Chile,3,3,2,3,-1,A3,47
A,Canada,3,0,0,4,-4,A4,47
B,Mexico,3,9,7,1,6,B1,47
B,Ecuador,3,4,6,4,2,B2,47
B,Venezuela,3,4,4,4,0,B3,47
B,Jamaica,3,0,1,9,-8,B4,47
C,United States,3,9,14,3,11,C1,47
C,Bolivia,3,6,6,7,-1,C2,47
C,Uruguay,3,3,4,8,-4,C3,47
C,Panama,3,0,1,7,-6,C4,47
D,Brazil,3,7,7,3,4,D1,47
D,Costa Rica,3,6,3,2,1,D2,47
D,Colombia,3,4,3,3,0,D3,47
D,Paraguay,3,0,1,6,-5,D4,47
A,Chile,3,5,5,2,3,A1,48
A,Argentina,3,5,3,1,2,A2,48
A,Canada,3,3,1,5,-4,A3,48
A,Peru,3,2,1,2,-1,A4,48
B,Mexico,3,7,5,2,3,B1,48
B,Ecuador,3,4,5,4,1,B2,48
B,Jamaica,3,2,4,5,-1,B3,48
B,Venezuela,3,2,4,7,-3,B4,48
C,Uruguay,3,7,3,1,2,C1,48
C,United States,3,5,5,4,1,C2,48
C,Panama,3,4,2,2,0,C3,48
C,Bolivia,3,0,4,7,-3,C4,48
D,Paraguay,3,9,5,0,5,D1,48
D,Brazil,3,6,6,2,4,D2,48
D,Colombia,3,3,1,5,-4,D3,48
D,Costa Rica,3,0,0,5,-5,D4,48
A,Argentina,3,6,4,3,1,A1,49
A,Canada,3,6,2,1,1,A2,49
A,Peru,3,4,3,3,0,A3,49
A,Chile,3,1,2,4,-2,A4,49
B,Venezuela,3,9,7,2,5,B1,49
B,Ecuador,3,4,9,6,3,B2,49
B,Mexico,3,4,4,4,0,B3,49
B,Jamaica,3,0,2,10,-8,B4,49
C,United States,3,7,12,5,7,C1,49
C,Uruguay,3,4,6,6,0,C2,49
C,Panama,3,4,5,6,-1,C3,49
C,Bolivia,3,1,3,9,-6,C4,49
D,Brazil,3,7,4,1,3,D1,49
D,Paraguay,3,4,6,4,2,D2,49
D,Colombia,3,4,3,3,0,D3,49
D,Costa Rica,3,1,1,6,-5,D4,49
A,Argentina,3,9,8,3,5,A1,50
A,Peru,3,4,4,4,0,A2,50
A,Canada,3,3,4,5,-1,A3,50
A,Chile,3,1,1,5,-4,A4,50
B,Mexico,3,7,3,0,3,B1,50
B,Venezuela,3,4,3,2,1,B2,50
B,Ecuador,3,3,4,5,-1,B3,50
B,Jamaica,3,3,1,4,-3,B4,50
C,United States,3,6,4,1,3,C1,50
C,Uruguay,3,4,2,2,0,C2,50
C,Bolivia,3,4,2,4,-2,C3,50
C,Panama,3,2,2,3,-1,C4,50
D,Costa Rica,3,6,5,2,3,D1,50
D,Colombia,3,6,3,4,-1,D2,50
D,Brazil,3,3,6,6,0,D3,50
D,Paraguay,3,3,2,4,-2,D4,50
A,Argentina,3,6,4,3,1,A1,51
A,Canada,3,4,4,4,0,A2,51
A,Peru,3,4,2,3,-1,A3,51
A,Chile,3,3,2,2,0,A4,51
B,Venezuela,3,5,4,3,1,B1,51
B,Mexico,3,3,3,3,0,B2,51
B,Jamaica,3,3,1,1,0,B3,51
B,Ecuador,3,2,1,2,-1,B4,51
C,United States,3,6,7,3,4,C1,51
C,Uruguay,3,6,4,3,1,C2,51
C,Panama,3,4,3,3,0,C3,51
C,Bolivia,3,1,1,6,-5,C4,51
D,Costa Rica,3,7,6,4,2,D1,51
D,Colombia,3,5,4,3,1,D2,51
D,Brazil,3,4,2,2,0,D3,51
D,Paraguay,3,0,4,7,-3,D4,51
A,Argentina,3,7,6,1,5,A1,52
A,Chile,3,6,6,1,5,A2,52
A,Canada,3,3,3,8,-5,A3,52
A,Peru,3,1,1,6,-5,A4,52
B,Mexico,3,7,5,1,4,B1,52
B,Ecuador,3,5,3,1,2,B2,52
B,Venezuela,3,4,6,4,2,B3,52
B,Jamaica,3,0,0,8,-8,B4,52
C,Uruguay,3,7,5,1,4,C1,52
C,United States,3,6,8,3,5,C2,52
C,Bolivia,3,4,3,7,-4,C3,52
C,Panama,3,0,1,6,-5,C4,52
D,Brazil,3,7,7,3,4,D1,52
D,Colombia,3,3,1,1,0,D2,52
D,Costa Rica,3,2,1,2,-1,D3,52
D,Paraguay,3,2,1,4,-3,D4,52
A,Argentina,3,7,7,4,3,A1,53
A,Peru,3,5,5,3,2,A2,53
A,Canada,3,4,4,5,-1,A3,53
A,Chile,3,0,4,8,-4,A4,53
B,Venezuela,3,7,3,1,2,B1,53
B,Mexico,3,4,6,3,3,B2,53
B,Jamaica,3,3,3,4,-1,B3,53
B,Ecuador,3,3,4,8,-4,B4,53
C,United States,3,7,5,1,4,C1,53
C,Uruguay,3,6,5,1,4,C2,53
C,Panama,3,4,3,3,0,C3,53
C,Bolivia,3,0,1,9,-8,C4,53
D,Brazil,3,9,9,1,8,D1,53
D,Costa Rica,3,4,2,4,-2,D2,53
D,Colombia,3,3,2,3,-1,D3,53
D,Paraguay,3,1,1,6,-5,D4,53
A,Argentina,3,6,7,5,2,A1,54
A,Chile,3,4,6,6,0,A2,54
A,Peru,3,4,4,4,0,A3,54
A,Canada,3,3,2,4,-2,A4,54
B,Mexico,3,9,9,3,6,B1,54
B,Ecuador,3,6,6,2,4,B2,54
B,Venezuela,3,3,3,4,-1,B3,54
B,Jamaica,3,0,1,10,-9,B4,54
C,United States,3,7,7,2,5,C1,54
C,Uruguay,3,7,4,0,4,C2,54
C,Panama,3,1,2,6,-4,C3,54
C,Bolivia,3,1,2,7,-5,C4,54
D,Colombia,3,7,3,0,3,D1,54
D,Brazil,3,4,3,4,-1,D2,54
D,Paraguay,3,3,4,3,1,D3,54
D,Costa Rica,3,2,1,4,-3,D4,54
A,Chile,3,5,3,1,2,A1,55
A,Argentina,3,5,4,3,1,A2,55
A,Canada,3,4,4,3,1,A3,55
A,Peru,3,1,2,6,-4,A4,55
B,Mexico,3,7,5,2,3,B1,55
B,Venezuela,3,5,5,3,2,B2,55
B,Ecuador,3,4,6,3,3,B3,55
B,Jamaica,3,0,1,9,-8,B4,55
C,United States,3,6,6,3,3,C1,55
C,Uruguay,3,4,7,3,4,C2,55
C,Panama,3,4,4,6,-2,C3,55
C,Bolivia,3,3,4,9,-5,C4,55
D,Brazil,3,9,8,1,7,D1,55
D,Paraguay,3,4,2,4,-2,D2,55
D,Colombia,3,3,3,2,1,D3,55
D,Costa Rica,3,1,2,8,-6,D4,55
A,Argentina,3,9,9,3,6,A1,56
A,Chile,3,2,4,5,-1,A2,56
A,Peru,3,2,1,3,-2,A3,56
A,Canada,3,2,2,5,-3,A4,56
B,Mexico,3,7,5,2,3,B1,56
B,Ecuador,3,6,4,2,2,B2,56
B,Venezuela,3,2,1,2,-1,B3,56
B,Jamaica,3,1,4,8,-4,B4,56
C,United States,3,9,10,1,9,C1,56
C,Uruguay,3,6,7,4,3,C2,56
C,Bolivia,3,3,4,9,-5,C3,56
C,Panama,3,0,3,10,-7,C4,56
D,Brazil,3,7,4,0,4,D1,56
D,Colombia,3,5,2,0,2,D2,56
D,Costa Rica,3,3,1,3,-2,D3,56
D,Paraguay,3,1,0,4,-4,D4,56
A,Argentina,3,9,6,1,5,A1,57
A,Chile,3,6,4,3,1,A2,57
A,Canada,3,1,1,3,-2,A3,57
A,Peru,3,1,0,4,-4,A4,57
B,Mexico,3,9,6,2,4,B1,57
B,Ecuador,3,4,7,4,3,B2,57
B,Venezuela,3,2,1,2,-1,B3,57
B,Jamaica,3,1,1,7,-6,B4,57
C,United States,3,7,6,1,5,C1,57
C,Uruguay,3,7,6,1,5,C2,57
C,Bolivia,3,1,2,6,-4,C3,57
C,Panama,3,1,2,8,-6,C4,57
D,Brazil,3,7,8,2,6,D1,57
D,Colombia,3,7,4,2,2,D2,57
D,Paraguay,3,3,4,5,-1,D3,57
D,Costa Rica,3,0,2,9,-7,D4,57
A,Argentina,3,7,5,3,2,A1,58
A,Canada,3,5,4,2,2,A2,58
A,Chile,3,2,3,4,-1,A3,58
A,Peru,3,1,0,3,-3,A4,58
B,Mexico,3,7,7,3,4,B1,58
B,Ecuador,3,5,4,3,1,B2,58
B,Venezuela,3,2,4,6,-2,B3,58
B,Jamaica,3,1,6,9,-3,B4,58
C,United States,3,7,4,1,3,C1,58
C,Panama,3,4,1,2,-1,C2,58
C,Bolivia,3,3,3,3,0,C3,58
C,Uruguay,3,3,3,5,-2,C4,58
D,Brazil,3,7,11,2,9,D1,58
D,Colombia,3,4,2,2,0,D2,58
D,Costa Rica,3,3,3,7,-4,D3,58
D,Paraguay,3,3,2,7,-5,D4,58
A,Chile,3,6,2,1,1,A1,59
A,Peru,3,6,2,1,1,A2,59
A,Argentina,3,4,2,2,0,A3,59
A,Canada,3,1,1,3,-2,A4,59
B,Mexico,3,5,4,2,2,B1,59
B,Venezuela,3,5,3,1,2,B2,59
B,Ecuador,3,5,3,2,1,B3,59
B,Jamaica,3,0,1,6,-5,B4,59
C,Uruguay,3,7,8,3,5,C1,59
C,United States,3,7,7,4,3,C2,59
C,Bolivia,3,3,1,4,-3,C3,59
C,Panama,3,0,1,6,-5,C4,59
D,Brazil,3,9,7,2,5,D1,59
D,Colombia,3,6,3,1,2,D2,59
D,Paraguay,3,1,0,3,-3,D3,59
D,Costa Rica,3,1,2,6,-4,D4,59
A,Argentina,3,9,9,3,6,A1,60
A,Chile,3,6,4,5,-1,A2,60
A,Canada,3,3,4,6,-2,A3,60
A,Peru,3,0,1,4,-3,A4,60
B,Ecuador,3,7,6,1,5,B1,60
B,Mexico,3,3,1,1,0,B2,60
B,Venezuela,3,2,1,3,-2,B3,60
B,Jamaica,3,2,1,4,-3,B4,60
C,United States,3,7,7,1,6,C1,60
C,Bolivia,3,6,5,7,-2,C2,60
C,Uruguay,3,4,4,4,0,C3,60
C,Panama,3,0,1,5,-4,C4,60
D,Colombia,3,7,6,1,5,D1,60
D,Brazil,3,6,5,1,4,D2,60
D,Paraguay,3,4,2,4,-2,D3,60
D,Costa Rica,3,0,1,8,-7,D4,60
A,Chile,3,7,7,2,5,A1,61
A,Argentina,3,5,2,1,1,A2,61
A,Canada,3,3,4,6,-2,A3,61
A,Peru,3,1,1,5,-4,A4,61
B,Mexico,3,4,5,4,1,B1,61
B,Ecuador,3,4,3,2,1,B2,61
B,Jamaica,3,4,4,5,-1,B3,61
B,Venezuela,3,4,2,3,-1,B4,61
C,Uruguay,3,6,5,3,2,C1,61
C,Panama,3,6,4,3,1,C2,61
C,United States,3,6,3,2,1,C3,61
C,Bolivia,3,0,1,5,-4,C4,61
D,Brazil,3,7,6,2,4,D1,61
D,Costa Rica,3,4,5,3,2,D2,61
D,Paraguay,3,4,3,5,-2,D3,61
D,Colombia,3,1,2,6,-4,D4,61
A,Argentina,3,7,3,1,2,A1,62
A,Canada,3,4,4,5,-1,A2,62
A,Peru,3,3,3,3,0,A3,62
A,Chile,3,3,3,4,-1,A4,62
B,Venezuela,3,5,3,2,1,B1,62
B,Ecuador,3,4,4,1,3,B2,62
B,Mexico,3,3,0,0,0,B3,62
B,Jamaica,3,2,2,6,-4,B4,62
C,Uruguay,3,9,10,3,7,C1,62
C,United States,3,6,3,2,1,C2,62
C,Panama,3,3,3,6,-3,C3,62
C,Bolivia,3,0,3,8,-5,C4,62
D,Brazil,3,7,6,3,3,D1,62
D,Colombia,3,6,4,3,1,D2,62
D,Paraguay,3,4,7,3,4,D3,62
D,Costa Rica,3,0,2,10,-8,D4,62
A,Argentina,3,9,6,1,5,A1,63
A,Peru,3,6,4,2,2,A2,63
A,Chile,3,3,3,3,0,A3,63
A,Canada,3,0,1,8,-7,A4,63
B,Ecuador,3,9,9,1,8,B1,63
B,Mexico,3,3,2,3,-1,B2,63
B,Venezuela,3,3,1,4,-3,B3,63
B,Jamaica,3,3,2,6,-4,B4,63
C,Uruguay,3,9,7,4,3,C1,63
C,United States,3,3,9,7,2,C2,63
C,Panama,3,3,8,9,-1,C3,63
C,Bolivia,3,3,3,7,-4,C4,63
D,Brazil,3,9,8,2,6,D1,63
D,Colombia,3,4,6,3,3,D2,63
D,Costa Rica,3,2,0,2,-2,D3,63
D,Paraguay,3,1,0,7,-7,D4,63
A,Argentina,3,6,6,2,4,A1,64
A,Peru,3,5,3,2,1,A2,64
A,Canada,3,2,3,4,-1,A3,64
A,Chile,3,2,2,6,-4,A4,64
B,Mexico,3,6,3,2,1,B1,64
B,Jamaica,3,4,3,3,0,B2,64
B,Ecuador,3,4,2,3,-1,B3,64
B,Venezuela,3,3,2,2,0,B4,64
C,United States,3,7,3,0,3,C1,64
C,Uruguay,3,6,4,1,3,C2,64
C,Panama,3,2,1,2,-1,C3,64
C,Bolivia,3,1,1,6,-5,C4,64
D,Brazil,3,9,10,0,10,D1,64
D,Colombia,3,6,4,3,1,D2,64
D,Costa Rica,3,1,1,6,-5,D3,64
D,Paraguay,3,1,1,7,-6,D4,64
A,Argentina,3,9,6,0,6,A1,65
A,Peru,3,3,3,4,-1,A2,65
A,Canada,3,3,1,3,-2,A3,65
A,Chile,3,3,2,5,-3,A4,65
B,Ecuador,3,7,4,2,2,B1,65
B,Mexico,3,5,6,3,3,B2,65
B,Venezuela,3,2,3,4,-1,B3,65
B,Jamaica,3,1,2,6,-4,B4,65
C,Uruguay,3,9,7,1,6,C1,65
C,United States,3,4,4,3,1,C2,65
C,Panama,3,2,2,4,-2,C3,65
C,Bolivia,3,1,1,6,-5,C4,65
D,Brazil,3,9,8,2,6,D1,65
D,Paraguay,3,4,2,2,0,D2,65
D,Costa Rica,3,3,2,5,-3,D3,65
D,Colombia,3,1,0,3,-3,D4,65
A,Argentina,3,9,12,2,10,A1,66
A,Peru,3,6,4,7,-3,A2,66
A,Chile,3,1,2,4,-2,A3,66
A,Canada,3,1,1,6,-5,A4,66
B,Mexico,3,7,6,2,4,B1,66
B,Jamaica,3,4,3,5,-2,B2,66
B,Ecuador,3,2,2,3,-1,B3,66
B,Venezuela,3,2,2,3,-1,B4,66
C,United States,3,7,8,2,6,C1,66
C,Uruguay,3,5,7,4,3,C2,66
C,Bolivia,3,4,4,5,-1,C3,66
C,Panama,3,0,4,12,-8,C4,66
D,Colombia,3,7,6,2,4,D1,66
D,Brazil,3,7,6,4,2,D2,66
D,Costa Rica,3,1,4,6,-2,D3,66
D,Paraguay,3,1,2,6,-4,D4,66
A,Argentina,3,5,3,2,1,A1,67
A,Canada,3,4,2,2,0,A2,67
A,Chile,3,4,2,2,0,A3,67
A,Peru,3,2,2,3,-1,A4,67
B,Mexico,3,6,5,3,2,B1,67
B,Venezuela,3,6,4,4,0,B2,67
B,Jamaica,3,3,5,6,-1,B3,67
B,Ecuador,3,3,2,3,-1,B4,67
C,Uruguay,3,9,8,2,6,C1,67
C,United States,3,6,7,3,4,C2,67
C,Panama,3,3,2,6,-4,C3,67
C,Bolivia,3,0,3,9,-6,C4,67
D,Paraguay,3,7,3,1,2,D1,67
D,Brazil,3,6,6,3,3,D2,67
D,Colombia,3,4,5,2,3,D3,67
D,Costa Rica,3,0,4,12,-8,D4,67
A,Argentina,3,5,5,3,2,A1,68
A,Canada,3,5,4,2,2,A2,68
A,Chile,3,2,3,5,-2,A3,68
A,Peru,3,2,2,4,-2,A4,68
B,Ecuador,3,5,3,2,1,B1,68
B,Jamaica,3,4,5,5,0,B2,68
B,Venezuela,3,4,3,3,0,B3,68
B,Mexico,3,3,4,5,-1,B4,68
C,United States,3,9,9,2,7,C1,68
C,Uruguay,3,4,6,3,3,C2,68
C,Panama,3,2,5,10,-5,C3,68
C,Bolivia,3,1,1,6,-5,C4,68
D,Brazil,3,7,4,1,3,D1,68
D,Paraguay,3,4,3,2,1,D2,68
D,Colombia,3,3,1,1,0,D3,68
D,Costa Rica,3,1,1,5,-4,D4,68
A,Peru,3,9,5,2,3,A1,69
A,Argentina,3,4,6,4,2,A2,69
A,Chile,3,2,2,3,-1,A3,69
A,Canada,3,1,1,5,-4,A4,69
B,Jamaica,3,7,3,1,2,B1,69
B,Mexico,3,4,2,2,0,B2,69
B,Venezuela,3,4,2,2,0,B3,69
B,Ecuador,3,1,1,3,-2,B4,69
C,United States,3,6,6,1,5,C1,69
C,Bolivia,3,6,3,4,-1,C2,69
C,Panama,3,3,3,5,-2,C3,69
C,Uruguay,3,3,1,3,-2,C4,69
D,Brazil,3,7,8,0,8,D1,69
D,Costa Rica,3,4,3,4,-1,D2,69
D,Colombia,3,3,1,1,0,D3,69
D,Paraguay,3,1,0,7,-7,D4,69
A,Argentina,3,9,12,4,8,A1,70
A,Chile,3,6,6,8,-2,A2,70
A,Canada,3,3,5,5,0,A3,70
A,Peru,3,0,4,10,-6,A4,70
B,Jamaica,3,6,4,3,1,B1,70
B,Ecuador,3,6,3,3,0,B2,70
B,Venezuela,3,3,2,2,0,B3,70
B,Mexico,3,3,3,4,-1,B4,70
C,Uruguay,3,9,5,1,4,C1,70
C,United States,3,6,6,3,3,C2,70
C,Panama,3,1,3,6,-3,C3,70
C,Bolivia,3,1,4,8,-4,C4,70
D,Brazil,3,9,7,1,6,D1,70
D,Colombia,3,3,2,2,0,D2,70
D,Paraguay,3,3,2,4,-2,D3,70
D,Costa Rica,3,3,3,7,-4,D4,70
A,Peru,3,5,4,1,3,A1,71
A,Argentina,3,5,2,1,1,A2,71
A,Chile,3,2,1,2,-1,A3,71
A,Canada,3,2,3,6,-3,A4,71
B,Venezuela,3,6,6,4,2,B1,71
B,Mexico,3,4,2,2,0,B2,71
B,Ecuador,3,4,3,5,-2,B3,71
B,Jamaica,3,3,5,5,0,B4,71
C,Uruguay,3,9,7,3,4,C1,71
C,United States,3,6,5,1,4,C2,71
C,Panama,3,3,1,3,-2,C3,71
C,Bolivia,3,0,3,9,-6,C4,71
D,Brazil,3,9,8,1,7,D1,71
D,Colombia,3,6,7,5,2,D2,71
D,Paraguay,3,3,2,3,-1,D3,71
D,Costa Rica,3,0,1,9,-8,D4,71
A,Chile,3,6,6,4,2,A1,72
A,Argentina,3,4,4,4,0,A2,72
A,Canada,3,4,4,5,-1,A3,72
A,Peru,3,2,5,6,-1,A4,72
B,Mexico,3,6,4,2,2,B1,72
B,Ecuador,3,5,6,4,2,B2,72
B,Venezuela,3,4,4,4,0,B3,72
B,Jamaica,3,1,2,6,-4,B4,72
C,United States,3,9,6,2,4,C1,72
C,Bolivia,3,4,5,6,-1,C2,72
C,Panama,3,2,2,3,-1,C3,72
C,Uruguay,3,1,2,4,-2,C4,72
D,Brazil,3,7,7,3,4,D1,72
D,Costa Rica,3,6,2,3,-1,D2,72
D,Colombia,3,4,3,3,0,D3,72
D,Paraguay,3,0,3,6,-3,D4,72
A,Argentina,3,5,6,3,3,A1,73
A,Peru,3,4,7,6,1,A2,73
A,Chile,3,4,3,6,-3,A3,73
A,Canada,3,3,5,6,-1,A4,73
B,Ecuador,3,6,4,2,2,B1,73
B,Venezuela,3,4,1,1,0,B2,73
B,Jamaica,3,4,4,5,-1,B3,73
B,Mexico,3,3,5,6,-1,B4,73
C,Uruguay,3,9,12,4,8,C1,73
C,United States,3,4,5,5,0,C2,73
C,Panama,3,3,5,9,-4,C3,73
C,Bolivia,3,1,2,6,-4,C4,73
D,Brazil,3,9,12,1,11,D1,73
D,Colombia,3,6,6,2,4,D2,73
D,Costa Rica,3,3,2,11,-9,D3,73
D,Paraguay,3,0,1,7,-6,D4,73
A,Argentina,3,7,6,2,4,A1,74
A,Chile,3,4,1,3,-2,A2,74
A,Peru,3,3,5,3,2,A3,74
A,Canada,3,2,1,5,-4,A4,74
B,Ecuador,3,7,4,0,4,B1,74
B,Venezuela,3,6,4,3,1,B2,74
B,Mexico,3,2,0,1,-1,B3,74
B,Jamaica,3,1,0,4,-4,B4,74
C,Uruguay,3,6,6,3,3,C1,74
C,United States,3,6,6,4,2,C2,74
C,Panama,3,3,4,5,-1,C3,74
C,Bolivia,3,3,2,6,-4,C4,74
D,Colombia,3,9,6,2,4,D1,74
D,Brazil,3,4,5,3,2,D2,74
D,Costa Rica,3,3,4,6,-2,D3,74
D,Paraguay,3,1,0,4,-4,D4,74
A,Chile,3,7,4,0,4,A1,75
A,Argentina,3,6,8,3,5,A2,75
A,Peru,3,4,2,3,-1,A3,75
A,Canada,3,0,1,9,-8,A4,75
B,Ecuador,3,9,7,2,5,B1,75
B,Mexico,3,6,5,2,3,B2,75
B,Venezuela,3,3,4,6,-2,B3,75
B,Jamaica,3,0,3,9,-6,B4,75
C,Uruguay,3,7,6,3,3,C1,75
C,United States,3,6,4,2,2,C2,75
C,Panama,3,4,4,4,0,C3,75
C,Bolivia,3,0,2,7,-5,C4,75
D,Brazil,3,7,8,3,5,D1,75
D,Colombia,3,7,4,2,2,D2,75
D,Paraguay,3,1,1,3,-2,D3,75
D,Costa Rica,3,1,0,5,-5,D4,75
A,Argentina,3,7,11,3,8,A1,76
A,Canada,3,4,6,4,2,A2,76
A,Chile,3,4,3,5,-2,A3,76
A,Peru,3,1,2,10,-8,A4,76
B,Venezuela,3,7,7,3,4,B1,76
B,Mexico,3,6,6,6,0,B2,76
B,Ecuador,3,3,3,5,-2,B3,76
B,Jamaica,3,1,2,4,-2,B4,76
C,United States,3,9,6,1,5,C1,76
C,Bolivia,3,6,4,3,1,C2,76
C,Uruguay,3,3,4,5,-1,C3,76
C,Panama,3,0,1,6,-5,C4,76
D,Colombia,3,7,3,0,3,D1,76
D,Brazil,3,6,4,2,2,D2,76
D,Paraguay,3,2,1,2,-1,D3,76
D,Costa Rica,3,1,2,6,-4,D4,76
A,Argentina,3,7,5,3,2,A1,77
A,Peru,3,5,3,2,1,A2,77
A,Chile,3,4,6,6,0,A3,77
A,Canada,3,0,4,7,-3,A4,77
B,Mexico,3,6,3,2,1,B1,77
B,Jamaica,3,5,5,3,2,B2,77
B,Ecuador,3,2,3,4,-1,B3,77
B,Venezuela,3,2,2,4,-2,B4,77
C,United States,3,9,4,1,3,C1,77
C,Panama,3,2,4,5,-1,C2,77
C,Bolivia,3,2,3,4,-1,C3,77
C,Uruguay,3,2,2,3,-1,C4,77
D,Colombia,3,7,5,2,3,D1,77
D,Costa Rica,3,6,4,2,2,D2,77
D,Brazil,3,4,3,1,2,D3,77
D,Paraguay,3,0,1,8,-7,D4,77
A,Argentina,3,7,4,1,3,A1,78
A,Peru,3,6,5,4,1,A2,78
A,Chile,3,3,3,4,-1,A3,78
A,Canada,3,1,4,7,-3,A4,78
B,Mexico,3,9,4,0,4,B1,78
B,Jamaica,3,6,4,2,2,B2,78
B,Venezuela,3,3,1,3,-2,B3,78
B,Ecuador,3,0,0,4,-4,B4,78
C,United States,3,5,4,1,3,C1,78
C,Uruguay,3,5,3,1,2,C2,78
C,Panama,3,4,2,4,-2,C3,78
C,Bolivia,3,1,1,4,-3,C4,78
D,Brazil,3,7,9,1,8,D1,78
D,Costa Rica,3,4,3,5,-2,D2,78
D,Paraguay,3,3,4,9,-5,D3,78
D,Colombia,3,2,2,3,-1,D4,78
A,Chile,3,7,7,3,4,A1,79
A,Argentina,3,5,5,2,3,A2,79
A,Peru,3,2,2,5,-3,A3,79
A,Canada,3,1,3,7,-4,A4,79
B,Ecuador,3,7,6,1,5,B1,79
B,Mexico,3,4,4,2,2,B2,79
B,Venezuela,3,4,3,3,0,B3,79
B,Jamaica,3,1,2,9,-7,B4,79
C,Uruguay,3,9,5,0,5,C1,79
C,United States,3,6,5,3,2,C2,79
C,Panama,3,3,4,4,0,C3,79
C,Bolivia,3,0,1,8,-7,C4,79
D,Brazil,3,6,5,1,4,D1,79
D,Colombia,3,6,4,2,2,D2,79
D,Costa Rica,3,4,3,4,-1,D3,79
D,Paraguay,3,1,1,6,-5,D4,79
A,Argentina,3,7,6,2,4,A1,80
A,Chile,3,5,6,4,2,A2,80
A,Peru,3,4,5,5,0,A3,80
A,Canada,3,0,1,7,-6,A4,80
B,Mexico,3,9,7,1,6,B1,80
B,Ecuador,3,4,2,2,0,B2,80
B,Venezuela,3,3,4,4,0,B3,80
B,Jamaica,3,1,1,7,-6,B4,80
C,Uruguay,3,7,11,2,9,C1,80
C,United States,3,6,7,5,2,C2,80
C,Panama,3,2,5,6,-1,C3,80
C,Bolivia,3,1,3,13,-10,C4,80
D,Brazil,3,7,3,0,3,D1,80
D,Paraguay,3,6,4,2,2,D2,80
D,Colombia,3,4,4,4,0,D3,80
D,Costa Rica,3,0,1,6,-5,D4,80
A,Argentina,3,9,11,0,11,A1,81
A,Canada,3,4,3,8,-5,A2,81
A,Peru,3,2,3,6,-3,A3,81
A,Chile,3,1,1,4,-3,A4,81
B,Mexico,3,6,4,3,1,B1,81
B,Venezuela,3,6,3,2,1,B2,81
B,Jamaica,3,3,2,2,0,B3,81
B,Ecuador,3,3,2,4,-2,B4,81
C,Uruguay,3,9,6,1,5,C1,81
C,United States,3,6,4,2,2,C2,81
C,Panama,3,3,2,3,-1,C3,81
C,Bolivia,3,0,2,8,-6,C4,81
D,Brazil,3,9,7,1,6,D1,81
D,Colombia,3,6,4,2,2,D2,81
D,Costa Rica,3,3,2,6,-4,D3,81
D,Paraguay,3,0,0,4,-4,D4,81
A,Peru,3,7,3,1,2,A1,82
A,Argentina,3,4,1,1,0,A2,82
A,Canada,3,2,2,3,-1,A3,82
A,Chile,3,2,1,2,-1,A4,82
B,Mexico,3,7,7,3,4,B1,82
B,Ecuador,3,5,5,3,2,B2,82
B,Jamaica,3,3,2,6,-4,B3,82
B,Venezuela,3,1,3,5,-2,B4,82
C,Uruguay,3,5,4,3,1,C1,82
C,United States,3,5,3,2,1,C2,82
C,Panama,3,4,5,5,0,C3,82
C,Bolivia,3,1,3,5,-2,C4,82
D,Colombia,3,5,4,1,3,D1,82
D,Brazil,3,4,2,2,0,D2,82
D,Costa Rica,3,4,3,4,-1,D3,82
D,Paraguay,3,3,3,5,-2,D4,82
A,Argentina,3,7,5,3,2,A1,83
A,Peru,3,5,4,2,2,A2,83
A,Chile,3,3,3,5,-2,A3,83
A,Canada,3,1,3,5,-2,A4,83
B,Mexico,3,7,5,1,4,B1,83
B,Ecuador,3,7,3,1,2,B2,83
B,Jamaica,3,3,2,3,-1,B3,83
B,Venezuela,3,0,1,6,-5,B4,83
C,United States,3,7,7,4,3,C1,83
C,Uruguay,3,4,5,5,0,C2,83
C,Bolivia,3,4,3,3,0,C3,83
C,Panama,3,1,2,5,-3,C4,83
D,Brazil,3,9,7,1,6,D1,83
D,Colombia,3,6,4,1,3,D2,83
D,Paraguay,3,3,2,5,-3,D3,83
D,Costa Rica,3,0,2,8,-6,D4,83
A,Argentina,3,7,3,0,3,A1,84
A,Canada,3,6,3,2,1,A2,84
A,Chile,3,4,2,2,0,A3,84
A,Peru,3,0,0,4,-4,A4,84
B,Ecuador,3,9,9,0,9,B1,84
B,Mexico,3,4,4,4,0,B2,84
B,Venezuela,3,3,2,7,-5,B3,84
B,Jamaica,3,1,1,5,-4,B4,84
C,United States,3,7,4,0,4,C1,84
C,Uruguay,3,4,2,2,0,C2,84
C,Panama,3,3,4,4,0,C3,84
C,Bolivia,3,3,4,8,-4,C4,84
D,Colombia,3,7,2,0,2,D1,84
D,Paraguay,3,5,3,2,1,D2,84
D,Brazil,3,2,2,3,-1,D3,84
D,Costa Rica,3,1,2,4,-2,D4,84
A,Argentina,3,5,2,1,1,A1,85
A,Chile,3,4,3,3,0,A2,85
A,Peru,3,3,0,0,0,A3,85
A,Canada,3,2,3,4,-1,A4,85
B,Mexico,3,7,7,3,4,B1,85
B,Venezuela,3,4,7,5,2,B2,85
B,Ecuador,3,4,4,2,2,B3,85
B,Jamaica,3,1,2,10,-8,B4,85
C,United States,3,6,5,1,4,C1,85
C,Bolivia,3,6,5,4,1,C2,85
C,Panama,3,6,2,1,1,C3,85
C,Uruguay,3,0,2,8,-6,C4,85
D,Brazil,3,7,10,1,9,D1,85
D,Colombia,3,5,3,1,2,D2,85
D,Paraguay,3,4,1,5,-4,D3,85
D,Costa Rica,3,0,0,7,-7,D4,85
A,Argentina,3,9,5,0,5,A1,86
A,Chile,3,4,4,4,0,A2,86
A,Peru,3,3,3,5,-2,A3,86
A,Canada,3,1,1,4,-3,A4,86
B,Venezuela,3,7,3,1,2,B1,86
B,Ecuador,3,3,4,4,0,B2,86
B,Jamaica,3,2,2,3,-1,B3,86
B,Mexico,3,2,1,2,-1,B4,86
C,Uruguay,3,6,5,2,3,C1,86
C,Panama,3,5,7,5,2,C2,86
C,United States,3,4,7,6,1,C3,86
C,Bolivia,3,1,3,9,-6,C4,86
D,Brazil,3,9,14,1,13,D1,86
D,Colombia,3,4,5,3,2,D2,86
D,Costa Rica,3,3,2,14,-12,D3,86
D,Paraguay,3,1,1,4,-3,D4,86
A,Argentina,3,9,11,0,11,A1,87
A,Peru,3,6,4,5,-1,A2,87
A,Canada,3,3,2,6,-4,A3,87
A,Chile,3,0,2,8,-6,A4,87
B,Mexico,3,7,5,1,4,B1,87
B,Ecuador,3,3,4,4,0,B2,87
B,Venezuela,3,2,2,3,-1,B3,87
B,Jamaica,3,2,3,6,-3,B4,87
C,Uruguay,3,7,6,2,4,C1,87
C,United States,3,7,6,3,3,C2,87
C,Panama,3,1,1,4,-3,C3,87
C,Bolivia,3,1,2,6,-4,C4,87
D,Colombia,3,7,6,2,4,D1,87
D,Brazil,3,3,3,3,0,D2,87
D,Costa Rica,3,2,2,3,-1,D3,87
D,Paraguay,3,2,5,8,-3,D4,87
A,Argentina,3,9,7,2,5,A1,88
A,Chile,3,6,5,2,3,A2,88
A,Peru,3,3,3,5,-2,A3,88
A,Canada,3,0,0,6,-6,A4,88
B,Ecuador,3,6,3,1,2,B1,88
B,Mexico,3,6,3,2,1,B2,88
B,Venezuela,3,6,2,1,1,B3,88
B,Jamaica,3,0,1,5,-4,B4,88
C,United States,3,7,9,2,7,C1,88
C,Uruguay,3,7,8,3,5,C2,88
C,Panama,3,1,2,7,-5,C3,88
C,Bolivia,3,1,1,8,-7,C4,88
D,Brazil,3,7,8,2,6,D1,88
D,Paraguay,3,4,3,4,-1,D2,88
D,Colombia,3,3,2,4,-2,D3,88
D,Costa Rica,3,3,1,4,-3,D4,88
A,Argentina,3,9,6,0,6,A1,89
A,Peru,3,6,4,2,2,A2,89
A,Chile,3,3,1,4,-3,A3,89
A,Canada,3,0,1,6,-5,A4,89
B,Mexico,3,6,6,3,3,B1,89
B,Ecuador,3,6,5,2,3,B2,89
B,Jamaica,3,6,2,2,0,B3,89
B,Venezuela,3,0,0,6,-6,B4,89
C,United States,3,7,7,1,6,C1,89
C,Uruguay,3,5,3,1,2,C2,89
C,Bolivia,3,4,2,3,-1,C3,89
C,Panama,3,0,1,8,-7,C4,89
D,Brazil,3,9,6,1,5,D1,89
D,Paraguay,3,6,4,2,2,D2,89
D,Colombia,3,3,3,4,-1,D3,89
D,Costa Rica,3,0,1,7,-6,D4,89
A,Argentina,3,9,7,2,5,A1,90
A,Chile,3,6,7,6,1,A2,90
A,Canada,3,3,4,6,-2,A3,90
A,Peru,3,0,1,5,-4,A4,90
B,Venezuela,3,6,7,2,5,B1,90
B,Jamaica,3,6,4,4,0,B2,90
B,Ecuador,3,3,4,6,-2,B3,90
B,Mexico,3,3,2,5,-3,B4,90
C,Uruguay,3,6,5,2,3,C1,90
C,United States,3,6,3,1,2,C2,90
C,Panama,3,3,2,3,-1,C3,90
C,Bolivia,3,3,1,5,-4,C4,90
D,Colombia,3,7,5,2,3,D1,90
D,Brazil,3,6,4,2,2,D2,90
D,Paraguay,3,4,2,3,-1,D3,90
D,Costa Rica,3,0,0,4,-4,D4,90
A,Argentina,3,6,4,1,3,A1,91
A,Chile,3,6,5,5,0,A2,91
A,Canada,3,4,3,4,-1,A3,91
A,Peru,3,1,2,4,-2,A4,91
B,Ecuador,3,4,4,3,1,B1,91
B,Mexico,3,4,3,3,0,B2,91
B,Jamaica,3,4,3,4,-1,B3,91
B,Venezuela,3,3,4,4,0,B4,91
C,Uruguay,3,6,4,2,2,C1,91
C,United States,3,4,4,3,1,C2,91
C,Bolivia,3,4,3,4,-1,C3,91
C,Panama,3,2,2,4,-2,C4,91
D,Brazil,3,9,7,3,4,D1,91
D,Colombia,3,4,6,2,4,D2,91
D,Costa Rica,3,3,2,8,-6,D3,91
D,Paraguay,3,1,5,7,-2,D4,91
A,Argentina,3,7,5,2,3,A1,92
A,Peru,3,4,4,5,-1,A2,92
A,Canada,3,3,3,3,0,A3,92
A,Chile,3,2,2,4,-2,A4,92
B,Mexico,3,5,6,3,3,B1,92
B,Ecuador,3,5,6,4,2,B2,92
B,Venezuela,3,4,4,4,0,B3,92
B,Jamaica,3,1,3,8,-5,B4,92
C,United States,3,7,5,2,3,C1,92
C,Uruguay,3,6,6,3,3,C2,92
C,Panama,3,4,3,6,-3,C3,92
C,Bolivia,3,0,1,4,-3,C4,92
D,Brazil,3,7,3,1,2,D1,92
D,Colombia,3,4,1,1,0,D2,92
D,Paraguay,3,3,4,4,0,D3,92
D,Costa Rica,3,2,1,3,-2,D4,92
A,Argentina,3,7,4,1,3,A1,93
A,Chile,3,6,4,2,2,A2,93
A,Peru,3,4,3,3,0,A3,93
A,Canada,3,0,0,5,-5,A4,93
B,Mexico,3,7,6,4,2,B1,93
B,Ecuador,3,5,3,2,1,B2,93
B,Venezuela,3,3,3,4,-1,B3,93
B,Jamaica,3,1,4,6,-2,B4,93
C,United States,3,5,4,1,3,C1,93
C,Uruguay,3,5,4,3,1,C2,93
C,Bolivia,3,2,2,3,-1,C3,93
C,Panama,3,2,2,5,-3,C4,93
D,Brazil,3,7,4,0,4,D1,93
D,Colombia,3,7,4,0,4,D2,93
D,Paraguay,3,3,2,6,-4,D3,93
D,Costa Rica,3,0,1,5,-4,D4,93
A,Chile,3,7,6,2,4,A1,94
A,Argentina,3,5,5,4,1,A2,94
A,Peru,3,2,0,3,-3,A3,94
A,Canada,3,1,2,4,-2,A4,94
B,Mexico,3,7,4,1,3,B1,94
B,Ecuador,3,4,2,2,0,B2,94
B,Venezuela,3,4,2,3,-1,B3,94
B,Jamaica,3,1,0,2,-2,B4,94
C,United States,3,7,5,2,3,C1,94
C,Uruguay,3,5,4,2,2,C2,94
C,Panama,3,4,7,5,2,C3,94
C,Bolivia,3,0,6,13,-7,C4,94
D,Brazil,3,6,4,3,1,D1,94
D,Costa Rica,3,4,4,3,1,D2,94
D,Paraguay,3,4,3,3,0,D3,94
D,Colombia,3,3,3,5,-2,D4,94
A,Canada,3,7,5,3,2,A1,95
A,Argentina,3,5,3,2,1,A2,95
A,Chile,3,4,5,4,1,A3,95
A,Peru,3,0,4,8,-4,A4,95
B,Venezuela,3,7,4,2,2,B1,95
B,Mexico,3,5,4,3,1,B2,95
B,Ecuador,3,4,4,4,0,B3,95
B,Jamaica,3,0,0,3,-3,B4,95
C,United States,3,6,6,3,3,C1,95
C,Uruguay,3,4,4,3,1,C2,95
C,Bolivia,3,4,3,4,-1,C3,95
C,Panama,3,2,3,6,-3,C4,95
D,Colombia,3,9,4,1,3,D1,95
D,Brazil,3,6,7,2,5,D2,95
D,Paraguay,3,1,3,6,-3,D3,95
D,Costa Rica,3,1,1,6,-5,D4,95
A,Peru,3,6,3,4,-1,A1,96
A,Argentina,3,4,5,3,2,A2,96
A,Chile,3,4,4,3,1,A3,96
A,Canada,3,3,2,4,-2,A4,96
B,Mexico,3,7,5,2,3,B1,96
B,Jamaica,3,4,4,4,0,B2,96
B,Ecuador,3,3,4,5,-1,B3,96
B,Venezuela,3,3,1,3,-2,B4,96
C,United States,3,9,10,2,8,C1,96
C,Uruguay,3,4,4,2,2,C2,96
C,Bolivia,3,3,2,8,-6,C3,96
C,Panama,3,1,1,5,-4,C4,96
D,Brazil,3,7,6,3,3,D1,96
D,Paraguay,3,6,5,3,2,D2,96
D,Colombia,3,3,4,5,-1,D3,96
D,Costa Rica,3,1,1,5,-4,D4,96
A,Canada,3,7,4,2,2,A1,97
A,Peru,3,5,1,0,1,A2,97
A,Chile,3,4,2,2,0,A3,97
A,Argentina,3,0,1,4,-3,A4,97
B,Ecuador,3,9,7,4,3,B1,97
B,Venezuela,3,3,4,3,1,B2,97
B,Jamaica,3,3,3,5,-2,B3,97
B,Mexico,3,3,3,5,-2,B4,97
C,United States,3,7,6,0,6,C1,97
C,Uruguay,3,6,6,7,-1,C2,97
C,Bolivia,3,4,4,4,0,C3,97
C,Panama,3,0,3,8,-5,C4,97
D,Colombia,3,7,3,1,2,D1,97
D,Brazil,3,4,3,2,1,D2,97
D,Costa Rica,3,4,1,1,0,D3,97
D,Paraguay,3,1,0,3,-3,D4,97
A,Chile,3,7,5,3,2,A1,98
A,Argentina,3,5,4,3,1,A2,98
A,Canada,3,4,5,4,1,A3,98
A,Peru,3,0,1,5,-4,A4,98
B,Mexico,3,7,4,1,3,B1,98
B,Venezuela,3,5,5,1,4,B2,98
B,Ecuador,3,4,2,3,-1,B3,98
B,Jamaica,3,0,1,7,-6,B4,98
C,Uruguay,3,9,6,1,5,C1,98
C,Bolivia,3,3,3,3,0,C2,98
C,United States,3,3,5,6,-1,C3,98
C,Panama,3,3,4,8,-4,C4,98
D,Brazil,3,7,5,1,4,D1,98
D,Colombia,3,5,3,1,2,D2,98
D,Paraguay,3,2,0,1,-1,D3,98
D,Costa Rica,3,1,0,5,-5,D4,98
A,Chile,3,7,5,1,4,A1,99
A,Argentina,3,5,3,1,2,A2,99
A,Canada,3,4,1,2,-1,A3,99
A,Peru,3,0,0,5,-5,A4,99
B,Mexico,3,9,6,3,3,B1,99
B,Venezuela,3,2,5,6,-1,B2,99
B,Ecuador,3,2,1,2,-1,B3,99
B,Jamaica,3,2,1,2,-1,B4,99
C,Uruguay,3,7,11,4,7,C1,99
C,United States,3,4,6,4,2,C2,99
C,Bolivia,3,3,4,8,-4,C3,99
C,Panama,3,3,4,9,-5,C4,99
D,Brazil,3,7,6,2,4,D1,99
D,Colombia,3,5,4,2,2,D2,99
D,Paraguay,3,2,0,1,-1,D3,99
D,Costa Rica,3,1,0,5,-5,D4,99
A,Peru,3,6,3,2,1,A1,100
A,Canada,3,4,4,4,0,A2,100
A,Chile,3,4,3,3,0,A3,100
A,Argentina,3,2,4,5,-1,A4,100
B,Venezuela,3,6,6,5,1,B1,100
B,Jamaica,3,6,3,2,1,B2,100
B,Mexico,3,4,6,4,2,B3,100
B,Ecuador,3,1,1,5,-4,B4,100
C,United States,3,7,10,1,9,C1,100
C,Uruguay,3,5,4,3,1,C2,100
C,Panama,3,3,3,8,-5,C3,100
C,Bolivia,3,1,2,7,-5,C4,100
D,Brazil,3,7,4,0,4,D1,100
D,Costa Rica,3,6,5,4,1,D2,100
D,Colombia,3,2,1,3,-2,D3,100
D,Paraguay,3,1,0,3,-3,D4,100
A,Argentina,3,5,6,2,4,A1,101
A,Canada,3,5,2,1,1,A2,101
A,Peru,3,5,2,1,1,A3,101
A,Chile,3,0,0,6,-6,A4,101
B,Venezuela,3,7,5,2,3,B1,101
B,Mexico,3,4,4,4,0,B2,101
B,Ecuador,3,2,3,4,-1,B3,101
B,Jamaica,3,2,3,5,-2,B4,101
C,United States,3,7,7,2,5,C1,101
C,Uruguay,3,7,5,2,3,C2,101
C,Panama,3,3,1,3,-2,C3,101
C,Bolivia,3,0,0,6,-6,C4,101
D,Brazil,3,7,4,1,3,D1,101
D,Paraguay,3,4,2,1,1,D2,101
D,Colombia,3,4,1,2,-1,D3,101
D,Costa Rica,3,1,1,4,-3,D4,101
A,Argentina,3,9,10,2,8,A1,102
A,Chile,3,4,3,3,0,A2,102
A,Peru,3,3,3,6,-3,A3,102
A,Canada,3,1,2,7,-5,A4,102
B,Venezuela,3,6,6,2,4,B1,102
B,Mexico,3,4,2,1,1,B2,102
B,Jamaica,3,4,1,4,-3,B3,102
B,Ecuador,3,3,1,3,-2,B4,102
C,Uruguay,3,6,8,5,3,C1,102
C,Bolivia,3,6,8,6,2,C2,102
C,United States,3,3,2,3,-1,C3,102
C,Panama,3,3,2,6,-4,C4,102
D,Colombia,3,7,4,2,2,D1,102
D,Paraguay,3,5,2,1,1,D2,102
D,Brazil,3,3,3,3,0,D3,102
D,Costa Rica,3,1,2,5,-3,D4,102
A,Chile,3,5,3,1,2,A1,103
A,Argentina,3,4,4,3,1,A2,103
A,Peru,3,4,2,3,-1,A3,103
A,Canada,3,3,3,5,-2,A4,103
B,Mexico,3,7,9,1,8,B1,103
B,Venezuela,3,7,6,3,3,B2,103
B,Jamaica,3,3,3,7,-4,B3,103
B,Ecuador,3,0,3,10,-7,B4,103
C,Uruguay,3,7,6,1,5,C1,103
C,United States,3,5,2,1,1,C2,103
C,Bolivia,3,2,1,4,-3,C3,103
C,Panama,3,1,3,6,-3,C4,103
D,Brazil,3,9,6,0,6,D1,103
D,Paraguay,3,6,5,2,3,D2,103
D,Colombia,3,3,2,4,-2,D3,103
D,Costa Rica,3,0,1,8,-7,D4,103
A,Argentina,3,7,7,3,4,A1,104
A,Chile,3,6,6,6,0,A2,104
A,Peru,3,4,6,3,3,A3,104
A,Canada,3,0,3,10,-7,A4,104
B,Mexico,3,6,6,2,4,B1,104
B,Jamaica,3,6,4,6,-2,B2,104
B,Venezuela,3,4,2,2,0,B3,104
B,Ecuador,3,1,2,4,-2,B4,104
C,United States,3,9,8,0,8,C1,104
C,Uruguay,3,6,5,3,2,C2,104
C,Panama,3,1,1,5,-4,C3,104
C,Bolivia,3,1,0,6,-6,C4,104
D,Brazil,3,9,8,1,7,D1,104
D,Colombia,3,3,5,4,1,D2,104
D,Paraguay,3,3,3,5,-2,D3,104
D,Costa Rica,3,3,2,8,-6,D4,104
A,Argentina,3,9,6,1,5,A1,105
A,Chile,3,6,7,4,3,A2,105
A,Peru,3,3,5,9,-4,A3,105
A,Canada,3,0,1,5,-4,A4,105
B,Ecuador,3,4,5,3,2,B1,105
B,Mexico,3,4,3,3,0,B2,105
B,Jamaica,3,4,1,3,-2,B3,105
B,Venezuela,3,3,2,2,0,B4,105
C,United States,3,7,7,2,5,C1,105
C,Uruguay,3,4,5,6,-1,C2,105
C,Bolivia,3,3,3,3,0,C3,105
C,Panama,3,1,3,7,-4,C4,105
D,Brazil,3,7,5,2,3,D1,105
D,Colombia,3,6,3,2,1,D2,105
D,Paraguay,3,2,2,3,-1,D3,105
D,Costa Rica,3,1,3,6,-3,D4,105
A,Peru,3,9,7,2,5,A1,106
A,Argentina,3,6,6,4,2,A2,106
A,Canada,3,3,4,4,0,A3,106
A,Chile,3,0,1,8,-7,A4,106
B,Mexico,3,7,4,1,3,B1,106
B,Ecuador,3,3,2,2,0,B2,106
B,Venezuela,3,2,3,4,-1,B3,106
B,Jamaica,3,2,2,4,-2,B4,106
C,United States,3,6,2,1,1,C1,106
C,Bolivia,3,4,3,3,0,C2,106
C,Uruguay,3,4,3,3,0,C3,106
C,Panama,3,3,1,2,-1,C4,106
D,Brazil,3,9,6,0,6,D1,106
D,Colombia,3,6,3,3,0,D2,106
D,Paraguay,3,3,3,5,-2,D3,106
D,Costa Rica,3,0,2,6,-4,D4,106
A,Argentina,3,7,7,1,6,A1,107
A,Chile,3,7,4,0,4,A2,107
A,Peru,3,3,3,5,-2,A3,107
A,Canada,3,0,1,9,-8,A4,107
B,Ecuador,3,9,5,1,4,B1,107
B,Mexico,3,6,5,2,3,B2,107
B,Jamaica,3,3,1,5,-4,B3,107
B,Venezuela,3,0,2,5,-3,B4,107
C,Uruguay,3,7,4,1,3,C1,107
C,Bolivia,3,4,3,2,1,C2,107
C,United States,3,3,3,4,-1,C3,107
C,Panama,3,2,2,5,-3,C4,107
D,Brazil,3,7,4,2,2,D1,107
D,Colombia,3,6,4,1,3,D2,107
D,Costa Rica,3,3,5,7,-2,D3,107
D,Paraguay,3,1,3,6,-3,D4,107
A,Chile,3,5,2,1,1,A1,108
A,Peru,3,4,2,1,1,A2,108
A,Canada,3,4,2,3,-1,A3,108
A,Argentina,3,3,1,2,-1,A4,108
B,Mexico,3,5,5,1,4,B1,108
B,Ecuador,3,4,3,3,0,B2,108
B,Venezuela,3,4,3,4,-1,B3,108
B,Jamaica,3,3,4,7,-3,B4,108
C,Uruguay,3,9,8,0,8,C1,108
C,United States,3,3,1,2,-1,C2,108
C,Panama,3,3,2,4,-2,C3,108
C,Bolivia,3,3,1,6,-5,C4,108
D,Brazil,3,6,6,3,3,D1,108
D,Colombia,3,6,5,4,1,D2,108
D,Costa Rica,3,4,4,4,0,D3,108
D,Paraguay,3,1,1,5,-4,D4,108
A,Argentina,3,7,7,2,5,A1,109
A,Chile,3,4,4,4,0,A2,109
A,Peru,3,3,1,2,-1,A3,109
A,Canada,3,3,2,6,-4,A4,109
B,Ecuador,3,9,7,1,6,B1,109
B,Mexico,3,6,4,4,0,B2,109
B,Venezuela,3,3,5,5,0,B3,109
B,Jamaica,3,0,1,7,-6,B4,109
C,Uruguay,3,6,7,2,5,C1,109
C,United States,3,6,4,3,1,C2,109
C,Bolivia,3,6,3,3,0,C3,109
C,Panama,3,0,2,8,-6,C4,109
D,Paraguay,3,6,4,1,3,D1,109
D,Brazil,3,6,2,1,1,D2,109
D,Colombia,3,4,2,2,0,D3,109
D,Costa Rica,3,1,1,5,-4,D4,109
A,Argentina,3,9,7,1,6,A1,110
A,Peru,3,4,3,4,-1,A2,110
A,Canada,3,3,3,5,-2,A3,110
A,Chile,3,1,3,6,-3,A4,110
B,Mexico,3,7,7,2,5,B1,110
B,Ecuador,3,6,8,4,4,B2,110
B,Jamaica,3,3,1,7,-6,B3,110
B,Venezuela,3,1,5,8,-3,B4,110
C,Uruguay,3,6,7,3,4,C1,110
C,United States,3,5,2,0,2,C2,110
C,Bolivia,3,4,4,4,0,C3,110
C,Panama,3,1,0,6,-6,C4,110
D,Brazil,3,5,4,2,2,D1,110
D,Costa Rica,3,4,4,3,1,D2,110
D,Colombia,3,3,2,2,0,D3,110
D,Paraguay,3,2,1,4,-3,D4,110
A,Argentina,3,9,7,0,7,A1,111
A,Peru,3,4,3,3,0,A2,111
A,Canada,3,2,2,5,-3,A3,111
A,Chile,3,1,1,5,-4,A4,111
B,Mexico,3,9,9,2,7,B1,111
B,Ecuador,3,4,5,5,0,B2,111
B,Venezuela,3,4,4,5,-1,B3,111
B,Jamaica,3,0,0,6,-6,B4,111
C,Uruguay,3,9,7,1,6,C1,111
C,United States,3,6,5,3,2,C2,111
C,Panama,3,3,2,5,-3,C3,111
C,Bolivia,3,0,2,7,-5,C4,111
D,Brazil,3,7,8,4,4,D1,111
D,Colombia,3,6,7,4,3,D2,111
D,Paraguay,3,4,7,5,2,D3,111
D,Costa Rica,3,0,1,10,-9,D4,111
A,Argentina,3,9,5,2,3,A1,112
A,Peru,3,4,3,3,0,A2,112
A,Chile,3,3,4,5,-1,A3,112
A,Canada,3,1,3,5,-2,A4,112
B,Ecuador,3,9,6,1,5,B1,112
B,Venezuela,3,4,5,5,0,B2,112
B,Jamaica,3,3,5,7,-2,B3,112
B,Mexico,3,1,4,7,-3,B4,112
C,Uruguay,3,6,5,3,2,C1,112
C,Bolivia,3,6,4,3,1,C2,112
C,Panama,3,3,2,3,-1,C3,112
C,United States,3,3,2,4,-2,C4,112
D,Brazil,3,7,4,2,2,D1,112
D,Colombia,3,6,4,2,2,D2,112
D,Costa Rica,3,3,3,4,-1,D3,112
D,Paraguay,3,1,2,5,-3,D4,112
A,Argentina,3,9,5,2,3,A1,113
A,Canada,3,2,2,3,-1,A2,113
A,Chile,3,2,2,3,-1,A3,113
A,Peru,3,2,2,3,-1,A4,113
B,Mexico,3,9,5,1,4,B1,113
B,Ecuador,3,4,4,2,2,B2,113
B,Venezuela,3,3,3,5,-2,B3,113
B,Jamaica,3,1,1,5,-4,B4,113
C,Uruguay,3,6,4,2,2,C1,113
C,United States,3,6,5,5,0,C2,113
C,Panama,3,4,3,3,0,C3,113
C,Bolivia,3,1,2,4,-2,C4,113
D,Colombia,3,7,5,1,4,D1,113
D,Brazil,3,4,3,4,-1,D2,113
D,Paraguay,3,3,1,1,0,D3,113
D,Costa Rica,3,1,1,4,-3,D4,113
A,Argentina,3,9,7,1,6,A1,114
A,Chile,3,6,8,5,3,A2,114
A,Canada,3,3,2,5,-3,A3,114
A,Peru,3,0,1,7,-6,A4,114
B,Mexico,3,9,4,1,3,B1,114
B,Venezuela,3,3,3,3,0,B2,114
B,Jamaica,3,3,4,5,-1,B3,114
B,Ecuador,3,3,3,5,-2,B4,114
C,United States,3,9,5,1,4,C1,114
C,Uruguay,3,4,4,3,1,C2,114
C,Bolivia,3,4,2,2,0,C3,114
C,Panama,3,0,2,7,-5,C4,114
D,Brazil,3,9,5,0,5,D1,114
D,Paraguay,3,3,3,3,0,D2,114
D,Colombia,3,3,3,5,-2,D3,114
D,Costa Rica,3,3,3,6,-3,D4,114
A,Argentina,3,7,4,0,4,A1,115
A,Peru,3,4,1,3,-2,A2,115
A,Chile,3,3,3,2,1,A3,115
A,Canada,3,3,1,4,-3,A4,115
B,Mexico,3,7,6,2,4,B1,115
B,Ecuador,3,4,4,2,2,B2,115
B,Jamaica,3,4,2,4,-2,B3,115
B,Venezuela,3,1,2,6,-4,B4,115
C,United States,3,9,8,2,6,C1,115
C,Uruguay,3,6,11,2,9,C2,115
C,Bolivia,3,3,3,9,-6,C3,115
C,Panama,3,0,1,10,-9,C4,115
D,Colombia,3,9,4,0,4,D1,115
D,Brazil,3,6,8,4,4,D2,115
D,Costa Rica,3,3,3,7,-4,D3,115
D,Paraguay,3,0,1,5,-4,D4,115
A,Argentina,3,7,4,1,3,A1,116
A,Canada,3,4,2,2,0,A2,116
A,Chile,3,2,3,4,-1,A3,116
A,Peru,3,2,1,3,-2,A4,116
B,Mexico,3,7,7,1,6,B1,116
B,Ecuador,3,6,5,2,3,B2,116
B,Venezuela,3,4,3,3,0,B3,116
B,Jamaica,3,0,0,9,-9,B4,116
C,Uruguay,3,9,7,1,6,C1,116
C,United States,3,6,4,1,3,C2,116
C,Panama,3,1,1,4,-3,C3,116
C,Bolivia,3,1,0,6,-6,C4,116
D,Colombia,3,6,5,3,2,D1,116
D,Paraguay,3,4,4,3,1,D2,116
D,Brazil,3,4,6,7,-1,D3,116
D,Costa Rica,3,3,3,5,-2,D4,116
A,Argentina,3,7,6,1,5,A1,117
A,Peru,3,6,4,5,-1,A2,117
A,Canada,3,3,4,5,-1,A3,117
A,Chile,3,1,1,4,-3,A4,117
B,Mexico,3,9,7,3,4,B1,117
B,Ecuador,3,3,3,3,0,B2,117
B,Venezuela,3,3,4,5,-1,B3,117
B,Jamaica,3,3,2,5,-3,B4,117
C,Uruguay,3,9,5,1,4,C1,117
C,United States,3,4,5,3,2,C2,117
C,Panama,3,2,1,2,-1,C3,117
C,Bolivia,3,1,1,6,-5,C4,117
D,Brazil,3,7,2,0,2,D1,117
D,Paraguay,3,4,2,1,1,D2,117
D,Costa Rica,3,3,2,3,-1,D3,117
D,Colombia,3,3,2,4,-2,D4,117
A,Chile,3,9,7,2,5,A1,118
A,Argentina,3,4,6,4,2,A2,118
A,Peru,3,3,3,4,-1,A3,118
A,Canada,3,1,1,7,-6,A4,118
B,Ecuador,3,5,5,3,2,B1,118
B,Mexico,3,5,3,1,2,B2,118
B,Venezuela,3,4,4,5,-1,B3,118
B,Jamaica,3,1,1,4,-3,B4,118
C,Uruguay,3,6,7,4,3,C1,118
C,United States,3,6,4,1,3,C2,118
C,Panama,3,6,4,3,1,C3,118
C,Bolivia,3,0,2,9,-7,C4,118
D,Brazil,3,6,5,2,3,D1,118
D,Colombia,3,6,2,3,-1,D2,118
D,Paraguay,3,4,2,1,1,D3,118
D,Costa Rica,3,1,0,3,-3,D4,118
A,Argentina,3,9,6,0,6,A1,119
A,Canada,3,4,2,2,0,A2,119
A,Chile,3,3,3,6,-3,A3,119
A,Peru,3,1,0,3,-3,A4,119
B,Ecuador,3,7,4,1,3,B1,119
B,Venezuela,3,7,4,2,2,B2,119
B,Mexico,3,3,4,4,0,B3,119
B,Jamaica,3,0,3,8,-5,B4,119
C,United States,3,7,6,2,4,C1,119
C,Uruguay,3,5,5,4,1,C2,119
C,Panama,3,2,2,4,-2,C3,119
C,Bolivia,3,1,2,5,-3,C4,119
D,Brazil,3,9,9,1,8,D1,119
D,Colombia,3,6,7,3,4,D2,119
D,Paraguay,3,1,0,5,-5,D3,119
D,Costa Rica,3,1,0,7,-7,D4,119
A,Chile,3,6,2,1,1,A1,120
A,Argentina,3,6,3,3,0,A2,120
A,Peru,3,3,4,3,1,A3,120
A,Canada,3,3,2,4,-2,A4,120
B,Mexico,3,9,6,3,3,B1,120
B,Jamaica,3,4,9,6,3,B2,120
B,Venezuela,3,3,4,7,-3,B3,120
B,Ecuador,3,1,4,7,-3,B4,120
C,Uruguay,3,7,6,2,4,C1,120
C,Panama,3,6,6,5,1,C2,120
C,United States,3,4,5,4,1,C3,120
C,Bolivia,3,0,0,6,-6,C4,120
D,Brazil,3,7,9,1,8,D1,120
D,Costa Rica,3,4,3,5,-2,D2,120
D,Colombia,3,3,2,2,0,D3,120
D,Paraguay,3,1,0,6,-6,D4,120
A,Argentina,3,6,5,3,2,A1,121
A,Chile,3,4,5,3,2,A2,121
A,Canada,3,4,2,4,-2,A3,121
A,Peru,3,3,2,4,-2,A4,121
B,Mexico,3,7,4,1,3,B1,121
B,Jamaica,3,4,3,5,-2,B2,121
B,Venezuela,3,3,4,4,0,B3,121
B,Ecuador,3,3,2,3,-1,B4,121
C,Panama,3,5,4,1,3,C1,121
C,United States,3,4,3,3,0,C2,121
C,Uruguay,3,4,1,1,0,C3,121
C,Bolivia,3,3,2,5,-3,C4,121
D,Brazil,3,9,6,2,4,D1,121
D,Colombia,3,6,6,2,4,D2,121
D,Paraguay,3,1,2,5,-3,D3,121
D,Costa Rica,3,1,3,8,-5,D4,121
A,Argentina,3,7,5,1,4,A1,122
A,Canada,3,6,5,5,0,A2,122
A,Peru,3,3,3,5,-2,A3,122
A,Chile,3,1,4,6,-2,A4,122
B,Venezuela,3,9,8,3,5,B1,122
B,Ecuador,3,6,3,2,1,B2,122
B,Mexico,3,3,1,4,-3,B3,122
B,Jamaica,3,0,2,5,-3,B4,122
C,United States,3,9,6,0,6,C1,122
C,Panama,3,4,3,4,-1,C2,122
C,Uruguay,3,3,5,4,1,C3,122
C,Bolivia,3,1,2,8,-6,C4,122
D,Brazil,3,9,11,3,8,D1,122
D,Colombia,3,6,6,2,4,D2,122
D,Paraguay,3,3,4,9,-5,D3,122
D,Costa Rica,3,0,2,9,-7,D4,122
A,Argentina,3,7,7,1,6,A1,123
A,Chile,3,4,3,5,-2,A2,123
A,Canada,3,3,3,4,-1,A3,123
A,Peru,3,2,2,5,-3,A4,123
B,Ecuador,3,7,4,1,3,B1,123
B,Mexico,3,4,3,3,0,B2,123
B,Jamaica,3,2,2,3,-1,B3,123
B,Venezuela,3,2,3,5,-2,B4,123
C,United States,3,7,9,3,6,C1,123
C,Uruguay,3,7,6,2,4,C2,123
C,Bolivia,3,3,4,6,-2,C3,123
C,Panama,3,0,0,8,-8,C4,123
D,Brazil,3,7,8,3,5,D1,123
D,Colombia,3,6,6,3,3,D2,123
D,Costa Rica,3,4,3,6,-3,D3,123
D,Paraguay,3,0,0,5,-5,D4,123
A,Argentina,3,7,9,2,7,A1,124
A,Chile,3,7,7,4,3,A2,124
A,Canada,3,1,2,7,-5,A3,124
A,Peru,3,1,0,5,-5,A4,124
B,Ecuador,3,9,8,3,5,B1,124
B,Venezuela,3,4,4,4,0,B2,124
B,Mexico,3,3,5,4,1,B3,124
B,Jamaica,3,1,2,8,-6,B4,124
C,Uruguay,3,5,5,1,4,C1,124
C,United States,3,5,5,2,3,C2,124
C,Panama,3,4,3,5,-2,C3,124
C,Bolivia,3,1,4,9,-5,C4,124
D,Brazil,3,7,5,3,2,D1,124
D,Colombia,3,7,3,1,2,D2,124
D,Paraguay,3,3,2,3,-1,D3,124
D,Costa Rica,3,0,5,8,-3,D4,124
A,Argentina,3,7,9,4,5,A1,125
A,Canada,3,7,4,1,3,A2,125
A,Chile,3,3,5,6,-1,A3,125
A,Peru,3,0,2,9,-7,A4,125
B,Ecuador,3,7,3,1,2,B1,125
B,Mexico,3,5,3,2,1,B2,125
B,Jamaica,3,3,1,2,-1,B3,125
B,Venezuela,3,1,1,3,-2,B4,125
C,United States,3,9,6,3,3,C1,125
C,Bolivia,3,6,4,2,2,C2,125
C,Uruguay,3,3,3,4,-1,C3,125
C,Panama,3,0,2,6,-4,C4,125
D,Brazil,3,9,5,0,5,D1,125
D,Colombia,3,6,3,1,2,D2,125
D,Paraguay,3,3,2,4,-2,D3,125
D,Costa Rica,3,0,0,5,-5,D4,125
A,Argentina,3,9,6,0,6,A1,126
A,Canada,3,6,3,2,1,A2,126
A,Peru,3,3,2,4,-2,A3,126
A,Chile,3,0,1,6,-5,A4,126
B,Mexico,3,7,4,1,3,B1,126
B,Venezuela,3,6,7,3,4,B2,126
B,Ecuador,3,2,2,4,-2,B3,126
B,Jamaica,3,1,2,7,-5,B4,126
C,Uruguay,3,9,10,2,8,C1,126
C,United States,3,4,9,6,3,C2,126
C,Bolivia,3,4,5,5,0,C3,126
C,Panama,3,0,0,11,-11,C4,126
D,Brazil,3,7,5,0,5,D1,126
D,Colombia,3,5,4,1,3,D2,126
D,Paraguay,3,2,0,1,-1,D3,126
D,Costa Rica,3,1,1,8,-7,D4,126
A,Peru,3,6,4,2,2,A1,127
A,Argentina,3,6,6,5,1,A2,127
A,Chile,3,3,3,4,-1,A3,127
A,Canada,3,3,4,6,-2,A4,127
B,Venezuela,3,9,10,2,8,B1,127
B,Ecuador,3,6,5,4,1,B2,127
B,Mexico,3,1,2,5,-3,B3,127
B,Jamaica,3,1,0,6,-6,B4,127
C,United States,3,9,9,2,7,C1,127
C,Uruguay,3,6,6,5,1,C2,127
C,Panama,3,1,3,5,-2,C3,127
C,Bolivia,3,1,3,9,-6,C4,127
D,Colombia,3,9,4,0,4,D1,127
D,Costa Rica,3,4,5,4,1,D2,127
D,Brazil,3,2,2,4,-2,D3,127
D,Paraguay,3,1,1,4,-3,D4,127
A,Argentina,3,7,4,2,2,A1,128
A,Peru,3,4,4,5,-1,A2,128
A,Canada,3,3,4,4,0,A3,128
A,Chile,3,3,4,5,-1,A4,128
B,Mexico,3,6,11,3,8,B1,128
B,Ecuador,3,6,5,4,1,B2,128
B,Venezuela,3,3,2,5,-3,B3,128
B,Jamaica,3,3,3,9,-6,B4,128
C,United States,3,7,7,2,5,C1,128
C,Uruguay,3,4,6,3,3,C2,128
C,Bolivia,3,3,5,10,-5,C3,128
C,Panama,3,2,2,5,-3,C4,128
D,Brazil,3,9,6,1,5,D1,128
D,Colombia,3,6,7,2,5,D2,128
D,Costa Rica,3,3,1,8,-7,D3,128
D,Paraguay,3,0,0,3,-3,D4,128
A,Argentina,3,6,5,2,3,A1,129
A,Chile,3,4,3,3,0,A2,129
A,Peru,3,4,3,5,-2,A3,129
A,Canada,3,2,3,4,-1,A4,129
B,Ecuador,3,9,6,1,5,B1,129
B,Mexico,3,6,8,3,5,B2,129
B,Venezuela,3,1,1,6,-5,B3,129
B,Jamaica,3,1,0,5,-5,B4,129
C,Uruguay,3,7,5,2,3,C1,129
C,United States,3,6,7,3,4,C2,129
C,Bolivia,3,3,5,8,-3,C3,129
C,Panama,3,1,3,7,-4,C4,129
D,Colombia,3,9,5,1,4,D1,129
D,Brazil,3,6,3,2,1,D2,129
D,Paraguay,3,3,4,6,-2,D3,129
D,Costa Rica,3,0,2,5,-3,D4,129
A,Argentina,3,6,6,2,4,A1,130
A,Peru,3,6,5,3,2,A2,130
A,Chile,3,3,4,4,0,A3,130
A,Canada,3,3,4,10,-6,A4,130
B,Mexico,3,6,6,1,5,B1,130
B,Ecuador,3,6,3,1,2,B2,130
B,Venezuela,3,3,3,3,0,B3,130
B,Jamaica,3,3,1,8,-7,B4,130
C,Uruguay,3,7,7,4,3,C1,130
C,United States,3,6,9,7,2,C2,130
C,Panama,3,2,3,5,-2,C3,130
C,Bolivia,3,1,7,10,-3,C4,130
D,Brazil,3,6,4,1,3,D1,130
D,Colombia,3,6,3,2,1,D2,130
D,Costa Rica,3,3,2,4,-2,D3,130
D,Paraguay,3,3,2,4,-2,D4,130
A,Canada,3,6,5,2,3,A1,131
A,Argentina,3,4,3,3,0,A2,131
A,Peru,3,4,1,2,-1,A3,131
A,Chile,3,3,2,4,-2,A4,131
B,Mexico,3,7,5,1,4,B1,131
B,Venezuela,3,6,5,3,2,B2,131
B,Jamaica,3,4,3,3,0,B3,131
B,Ecuador,3,0,3,9,-6,B4,131
C,United States,3,7,5,3,2,C1,131
C,Uruguay,3,5,5,4,1,C2,131
C,Panama,3,4,3,3,0,C3,131
C,Bolivia,3,0,1,4,-3,C4,131
D,Brazil,3,9,15,2,13,D1,131
D,Colombia,3,6,6,8,-2,D2,131
D,Costa Rica,3,3,4,9,-5,D3,131
D,Paraguay,3,0,1,7,-6,D4,131
A,Argentina,3,5,4,1,3,A1,132
A,Peru,3,5,2,1,1,A2,132
A,Chile,3,3,3,4,-1,A3,132
A,Canada,3,2,0,3,-3,A4,132
B,Mexico,3,9,10,3,7,B1,132
B,Ecuador,3,3,5,4,1,B2,132
B,Venezuela,3,3,6,10,-4,B3,132
B,Jamaica,3,3,5,9,-4,B4,132
C,Uruguay,3,6,6,3,3,C1,132
C,Panama,3,4,4,2,2,C2,132
C,United States,3,4,2,3,-1,C3,132
C,Bolivia,3,3,4,8,-4,C4,132
D,Brazil,3,7,9,1,8,D1,132
D,Colombia,3,4,3,3,0,D2,132
D,Paraguay,3,3,2,4,-2,D3,132
D,Costa Rica,3,3,1,7,-6,D4,132
A,Argentina,3,9,6,0,6,A1,133
A,Chile,3,6,5,2,3,A2,133
A,Peru,3,3,1,6,-5,A3,133
A,Canada,3,0,0,4,-4,A4,133
B,Venezuela,3,7,5,2,3,B1,133
B,Ecuador,3,6,6,3,3,B2,133
B,Mexico,3,3,4,7,-3,B3,133
B,Jamaica,3,1,1,4,-3,B4,133
C,United States,3,9,6,2,4,C1,133
C,Uruguay,3,6,5,1,4,C2,133
C,Panama,3,3,3,7,-4,C3,133
C,Bolivia,3,0,2,6,-4,C4,133
D,Brazil,3,7,5,2,3,D1,133
D,Colombia,3,5,5,3,2,D2,133
D,Paraguay,3,2,2,4,-2,D3,133
D,Costa Rica,3,1,3,6,-3,D4,133
A,Canada,3,6,3,1,2,A1,134
A,Chile,3,4,1,1,0,A2,134
A,Argentina,3,4,1,2,-1,A3,134
A,Peru,3,3,2,3,-1,A4,134
B,Mexico,3,7,3,1,2,B1,134
B,Ecuador,3,5,3,2,1,B2,134
B,Jamaica,3,4,3,3,0,B3,134
B,Venezuela,3,0,1,4,-3,B4,134
C,Uruguay,3,9,4,0,4,C1,134
C,United States,3,6,5,2,3,C2,134
C,Panama,3,3,4,4,0,C3,134
C,Bolivia,3,0,0,7,-7,C4,134
D,Brazil,3,7,8,3,5,D1,134
D,Paraguay,3,4,4,5,-1,D2,134
D,Colombia,3,4,3,5,-2,D3,134
D,Costa Rica,3,1,2,4,-2,D4,134
A,Argentina,3,5,4,2,2,A1,135
A,Chile,3,5,2,1,1,A2,135
A,Peru,3,4,3,2,1,A3,135
A,Canada,3,1,0,4,-4,A4,135
B,Venezuela,3,7,5,2,3,B1,135
B,Ecuador,3,7,3,0,3,B2,135
B,Mexico,3,3,2,2,0,B3,135
B,Jamaica,3,0,2,8,-6,B4,135
C,Uruguay,3,7,8,3,5,C1,135
C,United States,3,6,8,5,3,C2,135
C,Panama,3,2,3,6,-3,C3,135
C,Bolivia,3,1,1,6,-5,C4,135
D,Paraguay,3,7,4,2,2,D1,135
D,Brazil,3,3,3,3,0,D2,135
D,Costa Rica,3,2,7,8,-1,D3,135
D,Colombia,3,2,2,3,-1,D4,135
A,Argentina,3,7,5,2,3,A1,136
A,Chile,3,4,8,4,4,A2,136
A,Canada,3,3,3,9,-6,A3,136
A,Peru,3,2,3,4,-1,A4,136
B,Mexico,3,7,4,1,3,B1,136
B,Ecuador,3,4,1,3,-2,B2,136
B,Jamaica,3,3,4,4,0,B3,136
B,Venezuela,3,3,1,2,-1,B4,136
C,Uruguay,3,7,7,2,5,C1,136
C,United States,3,5,4,1,3,C2,136
C,Bolivia,3,3,2,8,-6,C3,136
C,Panama,3,1,2,4,-2,C4,136
D,Brazil,3,7,7,2,5,D1,136
D,Colombia,3,5,5,3,2,D2,136
D,Costa Rica,3,2,5,8,-3,D3,136
D,Paraguay,3,1,4,8,-4,D4,136
A,Argentina,3,5,4,1,3,A1,137
A,Canada,3,4,3,3,0,A2,137
A,Peru,3,3,0,0,0,A3,137
A,Chile,3,2,1,4,-3,A4,137
B,Ecuador,3,7,9,3,6,B1,137
B,Mexico,3,6,7,4,3,B2,137
B,Venezuela,3,4,2,3,-1,B3,137
B,Jamaica,3,0,1,9,-8,B4,137
C,United States,3,9,8,2,6,C1,137
C,Bolivia,3,6,4,4,0,C2,137
C,Uruguay,3,3,5,4,1,C3,137
C,Panama,3,0,2,9,-7,C4,137
D,Brazil,3,7,2,0,2,D1,137
D,Paraguay,3,5,1,0,1,D2,137
D,Colombia,3,4,4,4,0,D3,137
D,Costa Rica,3,0,3,6,-3,D4,137
A,Argentina,3,7,8,2,6,A1,138
A,Peru,3,6,3,5,-2,A2,138
A,Canada,3,2,3,4,-1,A3,138
A,Chile,3,1,2,5,-3,A4,138
B,Mexico,3,9,7,2,5,B1,138
B,Ecuador,3,6,3,2,1,B2,138
B,Jamaica,3,3,3,3,0,B3,138
B,Venezuela,3,0,4,10,-6,B4,138
C,Uruguay,3,7,7,1,6,C1,138
C,Panama,3,6,5,6,-1,C2,138
C,United States,3,4,7,4,3,C3,138
C,Bolivia,3,0,1,9,-8,C4,138
D,Colombia,3,7,7,1,6,D1,138
D,Brazil,3,5,3,2,1,D2,138
D,Costa Rica,3,2,1,3,-2,D3,138
D,Paraguay,3,1,0,5,-5,D4,138
A,Canada,3,7,4,2,2,A1,139
A,Argentina,3,6,7,1,6,A2,139
A,Peru,3,2,2,4,-2,A3,139
A,Chile,3,1,2,8,-6,A4,139
B,Ecuador,3,6,6,1,5,B1,139
B,Mexico,3,6,4,2,2,B2,139
B,Venezuela,3,4,2,2,0,B3,139
B,Jamaica,3,1,0,7,-7,B4,139
C,Uruguay,3,7,6,2,4,C1,139
C,United States,3,6,6,2,4,C2,139
C,Panama,3,3,2,7,-5,C3,139
C,Bolivia,3,1,1,4,-3,C4,139
D,Brazil,3,7,11,2,9,D1,139
D,Colombia,3,6,5,4,1,D2,139
D,Paraguay,3,2,3,6,-3,D3,139
D,Costa Rica,3,1,1,8,-7,D4,139
A,Canada,3,6,3,3,0,A1,140
A,Argentina,3,5,4,2,2,A2,140
A,Peru,3,4,4,4,0,A3,140
A,Chile,3,1,2,4,-2,A4,140
B,Mexico,3,9,7,1,6,B1,140
B,Ecuador,3,6,5,3,2,B2,140
B,Venezuela,3,1,3,6,-3,B3,140
B,Jamaica,3,1,3,8,-5,B4,140
C,United States,3,7,8,1,7,C1,140
C,Uruguay,3,6,6,4,2,C2,140
C,Bolivia,3,3,3,5,-2,C3,140
C,Panama,3,1,1,8,-7,C4,140
D,Brazil,3,9,8,2,6,D1,140
D,Paraguay,3,3,5,5,0,D2,140
D,Costa Rica,3,3,3,5,-2,D3,140
D,Colombia,3,3,2,6,-4,D4,140
A,Argentina,3,9,7,0,7,A1,141
A,Canada,3,4,3,2,1,A2,141
A,Peru,3,2,1,4,-3,A3,141
A,Chile,3,1,0,5,-5,A4,141
B,Mexico,3,7,5,3,2,B1,141
B,Ecuador,3,4,3,3,0,B2,141
B,Venezuela,3,2,2,3,-1,B3,141
B,Jamaica,3,2,1,2,-1,B4,141
C,Uruguay,3,6,7,4,3,C1,141
C,United States,3,4,4,3,1,C2,141
C,Panama,3,4,4,5,-1,C3,141
C,Bolivia,3,2,3,6,-3,C4,141
D,Brazil,3,7,4,1,3,D1,141
D,Paraguay,3,4,4,3,1,D2,141
D,Costa Rica,3,2,1,2,-1,D3,141
D,Colombia,3,2,1,4,-3,D4,141
A,Argentina,3,7,6,1,5,A1,142
A,Peru,3,4,2,3,-1,A2,142
A,Canada,3,3,2,5,-3,A3,142
A,Chile,3,2,0,1,-1,A4,142
B,Ecuador,3,6,4,1,3,B1,142
B,Mexico,3,5,4,3,1,B2,142
B,Venezuela,3,4,6,5,1,B3,142
B,Jamaica,3,1,2,7,-5,B4,142
C,United States,3,6,5,1,4,C1,142
C,Uruguay,3,6,5,4,1,C2,142
C,Panama,3,6,3,2,1,C3,142
C,Bolivia,3,0,1,7,-6,C4,142
D,Brazil,3,9,6,0,6,D1,142
D,Colombia,3,4,3,3,0,D2,142
D,Costa Rica,3,2,1,2,-1,D3,142
D,Paraguay,3,1,1,6,-5,D4,142
A,Peru,3,9,5,2,3,A1,143
A,Chile,3,6,4,2,2,A2,143
A,Argentina,3,3,4,4,0,A3,143
A,Canada,3,0,1,6,-5,A4,143
B,Venezuela,3,7,4,0,4,B1,143
B,Mexico,3,4,3,4,-1,B2,143
B,Ecuador,3,3,4,3,1,B3,143
B,Jamaica,3,3,1,5,-4,B4,143
C,Uruguay,3,9,7,1,6,C1,143
C,United States,3,6,9,2,7,C2,143
C,Bolivia,3,1,1,7,-6,C3,143
C,Panama,3,1,1,8,-7,C4,143
D,Colombia,3,7,6,3,3,D1,143
D,Brazil,3,6,6,4,2,D2,143
D,Paraguay,3,4,3,4,-1,D3,143
D,Costa Rica,3,0,2,6,-4,D4,143
A,Chile,3,6,6,3,3,A1,144
A,Argentina,3,6,4,3,1,A2,144
A,Peru,3,3,2,3,-1,A3,144
A,Canada,3,3,2,5,-3,A4,144
B,Venezuela,3,7,5,2,3,B1,144
B,Mexico,3,4,5,4,1,B2,144
B,Ecuador,3,3,5,6,-1,B3,144
B,Jamaica,3,2,2,5,-3,B4,144
C,United States,3,7,4,2,2,C1,144
C,Uruguay,3,6,5,1,4,C2,144
C,Bolivia,3,2,3,6,-3,C3,144
C,Panama,3,1,3,6,-3,C4,144
D,Paraguay,3,6,6,2,4,D1,144
D,Brazil,3,6,5,4,1,D2,144
D,Colombia,3,6,5,4,1,D3,144
D,Costa Rica,3,0,1,7,-6,D4,144
A,Chile,3,7,8,3,5,A1,145
A,Argentina,3,7,6,1,5,A2,145
A,Canada,3,1,1,5,-4,A3,145
A,Peru,3,1,1,7,-6,A4,145
B,Ecuador,3,6,4,3,1,B1,145
B,Mexico,3,5,5,2,3,B2,145
B,Venezuela,3,4,5,6,-1,B3,145
B,Jamaica,3,1,1,4,-3,B4,145
C,United States,3,7,5,1,4,C1,145
C,Uruguay,3,6,3,1,2,C2,145
C,Bolivia,3,4,4,3,1,C3,145
C,Panama,3,0,1,8,-7,C4,145
D,Brazil,3,7,8,5,3,D1,145
D,Colombia,3,6,7,3,4,D2,145
D,Paraguay,3,3,3,4,-1,D3,145
D,Costa Rica,3,1,3,9,-6,D4,145
A,Argentina,3,7,5,1,4,A1,146
A,Chile,3,6,3,4,-1,A2,146
A,Peru,3,2,3,4,-1,A3,146
A,Canada,3,1,1,3,-2,A4,146
B,Venezuela,3,9,4,1,3,B1,146
B,Mexico,3,6,5,3,2,B2,146
B,Ecuador,3,3,1,3,-2,B3,146
B,Jamaica,3,0,3,6,-3,B4,146
C,United States,3,7,4,1,3,C1,146
C,Uruguay,3,5,6,0,6,C2,146
C,Panama,3,4,2,2,0,C3,146
C,Bolivia,3,0,0,9,-9,C4,146
D,Paraguay,3,5,5,4,1,D1,146
D,Colombia,3,5,2,1,1,D2,146
D,Brazil,3,3,3,2,1,D3,146
D,Costa Rica,3,2,3,6,-3,D4,146
A,Peru,3,6,6,4,2,A1,147
A,Argentina,3,6,5,3,2,A2,147
A,Chile,3,6,5,3,2,A3,147
A,Canada,3,0,3,9,-6,A4,147
B,Jamaica,3,5,3,2,1,B1,147
B,Ecuador,3,4,6,4,2,B2,147
B,Mexico,3,4,5,7,-2,B3,147
B,Venezuela,3,2,1,2,-1,B4,147
C,United States,3,9,12,3,9,C1,147
C,Uruguay,3,4,6,5,1,C2,147
C,Bolivia,3,3,4,9,-5,C3,147
C,Panama,3,1,4,9,-5,C4,147
D,Brazil,3,5,4,2,2,D1,147
D,Colombia,3,3,3,3,0,D2,147
D,Costa Rica,3,3,3,3,0,D3,147
D,Paraguay,3,2,2,4,-2,D4,147
A,Chile,3,7,3,1,2,A1,148
A,Canada,3,4,3,3,0,A2,148
A,Argentina,3,3,3,3,0,A3,148
A,Peru,3,2,2,4,-2,A4,148
B,Mexico,3,9,7,0,7,B1,148
B,Venezuela,3,3,2,2,0,B2,148
B,Ecuador,3,3,1,3,-2,B3,148
B,Jamaica,3,3,1,6,-5,B4,148
C,Uruguay,3,9,9,3,6,C1,148
C,Panama,3,3,4,5,-1,C2,148
C,Bolivia,3,3,3,5,-2,C3,148
C,United States,3,3,3,6,-3,C4,148
D,Colombia,3,7,10,4,6,D1,148
D,Brazil,3,6,7,4,3,D2,148
D,Paraguay,3,3,4,6,-2,D3,148
D,Costa Rica,3,1,3,10,-7,D4,148
A,Argentina,3,7,11,8,3,A1,149
A,Chile,3,6,7,5,2,A2,149
A,Peru,3,2,3,4,-1,A3,149
A,Canada,3,1,5,9,-4,A4,149
B,Ecuador,3,9,10,1,9,B1,149
B,Mexico,3,6,9,3,6,B2,149
B,Venezuela,3,3,3,9,-6,B3,149
B,Jamaica,3,0,1,10,-9,B4,149
C,Uruguay,3,7,3,1,2,C1,149
C,United States,3,4,3,3,0,C2,149
C,Bolivia,3,3,4,4,0,C3,149
C,Panama,3,1,1,3,-2,C4,149
D,Colombia,3,5,8,4,4,D1,149
D,Brazil,3,4,4,3,1,D2,149
D,Paraguay,3,4,4,4,0,D3,149
D,Costa Rica,3,3,4,9,-5,D4,149
A,Chile,3,6,3,1,2,A1,150
A,Peru,3,6,4,3,1,A2,150
A,Argentina,3,3,3,3,0,A3,150
A,Canada,3,3,2,5,-3,A4,150
B,Mexico,3,6,3,1,2,B1,150
B,Ecuador,3,6,4,3,1,B2,150
B,Jamaica,3,3,4,5,-1,B3,150
B,Venezuela,3,3,3,5,-2,B4,150
C,United States,3,7,12,5,7,C1,150
C,Uruguay,3,5,5,3,2,C2,150
C,Panama,3,4,6,5,1,C3,150
C,Bolivia,3,0,1,11,-10,C4,150
D,Brazil,3,7,6,2,4,D1,150
D,Colombia,3,7,5,3,2,D2,150
D,Costa Rica,3,3,1,4,-3,D3,150
D,Paraguay,3,0,1,4,-3,D4,150
A,Argentina,3,7,4,1,3,A1,151
A,Chile,3,4,2,3,-1,A2,151
A,Canada,3,2,2,3,-1,A3,151
A,Peru,3,2,2,3,-1,A4,151
B,Venezuela,3,6,6,4,2,B1,151
B,Ecuador,3,6,4,3,1,B2,151
B,Mexico,3,4,2,2,0,B3,151
B,Jamaica,3,1,2,5,-3,B4,151
C,Uruguay,3,9,8,2,6,C1,151
C,Panama,3,6,4,4,0,C2,151
C,United States,3,3,2,4,-2,C3,151
C,Bolivia,3,0,1,5,-4,C4,151
D,Brazil,3,9,7,2,5,D1,151
D,Colombia,3,4,5,4,1,D2,151
D,Costa Rica,3,2,3,5,-2,D3,151
D,Paraguay,3,1,2,6,-4,D4,151
A,Canada,3,7,4,2,2,A1,152
A,Chile,3,4,4,4,0,A2,152
A,Peru,3,3,3,3,0,A3,152
A,Argentina,3,3,5,7,-2,A4,152
B,Ecuador,3,9,5,2,3,B1,152
B,Mexico,3,6,7,3,4,B2,152
B,Jamaica,3,3,3,4,-1,B3,152
B,Venezuela,3,0,1,7,-6,B4,152
C,Uruguay,3,6,6,3,3,C1,152
C,United States,3,6,7,6,1,C2,152
C,Bolivia,3,6,6,5,1,C3,152
C,Panama,3,0,1,6,-5,C4,152
D,Brazil,3,9,6,3,3,D1,152
D,Costa Rica,3,4,4,3,1,D2,152
D,Colombia,3,3,1,3,-2,D3,152
D,Paraguay,3,1,1,3,-2,D4,152
A,Argentina,3,7,7,2,5,A1,153
A,Chile,3,4,2,5,-3,A2,153
A,Peru,3,3,1,2,-1,A3,153
A,Canada,3,2,3,4,-1,A4,153
B,Ecuador,3,9,5,1,4,B1,153
B,Mexico,3,6,4,3,1,B2,153
B,Jamaica,3,3,1,3,-2,B3,153
B,Venezuela,3,0,0,3,-3,B4,153
C,United States,3,9,9,0,9,C1,153
C,Uruguay,3,4,5,1,4,C2,153
C,Bolivia,3,3,3,12,-9,C3,153
C,Panama,3,1,2,6,-4,C4,153
D,Paraguay,3,7,5,3,2,D1,153
D,Costa Rica,3,6,5,4,1,D2,153
D,Brazil,3,4,3,3,0,D3,153
D,Colombia,3,0,2,5,-3,D4,153
A,Argentina,3,9,9,3,6,A1,154
A,Peru,3,4,2,2,0,A2,154
A,Canada,3,3,3,5,-2,A3,154
A,Chile,3,1,2,6,-4,A4,154
B,Mexico,3,9,6,1,5,B1,154
B,Ecuador,3,6,4,3,1,B2,154
B,Venezuela,3,3,3,4,-1,B3,154
B,Jamaica,3,0,2,7,-5,B4,154
C,United States,3,9,5,1,4,C1,154
C,Uruguay,3,6,3,1,2,C2,154
C,Panama,3,3,1,3,-2,C3,154
C,Bolivia,3,0,1,5,-4,C4,154
D,Brazil,3,9,9,2,7,D1,154
D,Paraguay,3,6,4,3,1,D2,154
D,Colombia,3,1,1,4,-3,D3,154
D,Costa Rica,3,1,0,5,-5,D4,154
A,Canada,3,9,6,3,3,A1,155
A,Argentina,3,6,7,4,3,A2,155
A,Peru,3,1,2,5,-3,A3,155
A,Chile,3,1,0,3,-3,A4,155
B,Venezuela,3,7,9,4,5,B1,155
B,Ecuador,3,6,9,4,5,B2,155
B,Mexico,3,4,6,6,0,B3,155
B,Jamaica,3,0,0,10,-10,B4,155
C,United States,3,7,6,4,2,C1,155
C,Bolivia,3,5,2,0,2,C2,155
C,Uruguay,3,4,5,2,3,C3,155
C,Panama,3,0,3,10,-7,C4,155
D,Colombia,3,7,4,2,2,D1,155
D,Paraguay,3,5,5,3,2,D2,155
D,Brazil,3,2,3,4,-1,D3,155
D,Costa Rica,3,1,0,3,-3,D4,155
A,Peru,3,7,5,1,4,A1,156
A,Argentina,3,4,5,7,-2,A2,156
A,Canada,3,2,3,4,-1,A3,156
A,Chile,3,2,2,3,-1,A4,156
B,Jamaica,3,7,4,1,3,B1,156
B,Mexico,3,4,3,3,0,B2,156
B,Ecuador,3,2,5,6,-1,B3,156
B,Venezuela,3,2,2,4,-2,B4,156
C,Panama,3,7,5,2,3,C1,156
C,Uruguay,3,4,4,2,2,C2,156
C,United States,3,3,2,2,0,C3,156
C,Bolivia,3,1,1,6,-5,C4,156
D,Brazil,3,9,6,3,3,D1,156
D,Paraguay,3,6,4,2,2,D2,156
D,Colombia,3,1,2,4,-2,D3,156
D,Costa Rica,3,1,2,5,-3,D4,156
A,Peru,3,6,5,4,1,A1,157
A,Argentina,3,6,3,2,1,A2,157
A,Chile,3,3,3,3,0,A3,157
A,Canada,3,3,3,5,-2,A4,157
B,Mexico,3,7,6,2,4,B1,157
B,Venezuela,3,6,5,4,1,B2,157
B,Jamaica,3,4,3,5,-2,B3,157
B,Ecuador,3,0,1,4,-3,B4,157
C,United States,3,9,5,0,5,C1,157
C,Bolivia,3,3,3,4,-1,C2,157
C,Uruguay,3,3,3,4,-1,C3,157
C,Panama,3,3,2,5,-3,C4,157
D,Brazil,3,5,4,3,1,D1,157
D,Paraguay,3,4,2,2,0,D2,157
D,Colombia,3,3,2,2,0,D3,157
D,Costa Rica,3,2,2,3,-1,D4,157
A,Argentina,3,9,10,1,9,A1,158
A,Peru,3,4,4,4,0,A2,158
A,Canada,3,2,2,7,-5,A3,158
A,Chile,3,1,4,8,-4,A4,158
B,Mexico,3,9,8,1,7,B1,158
B,Ecuador,3,6,5,2,3,B2,158
B,Venezuela,3,3,4,6,-2,B3,158
B,Jamaica,3,0,1,9,-8,B4,158
C,Uruguay,3,9,7,0,7,C1,158
C,Bolivia,3,2,2,4,-2,C2,158
C,Panama,3,2,1,3,-2,C3,158
C,United States,3,2,1,4,-3,C4,158
D,Brazil,3,9,7,0,7,D1,158
D,Costa Rica,3,4,1,3,-2,D2,158
D,Colombia,3,3,1,2,-1,D3,158
D,Paraguay,3,1,0,4,-4,D4,158
A,Chile,3,7,6,3,3,A1,159
A,Canada,3,4,5,4,1,A2,159
A,Peru,3,4,3,3,0,A3,159
A,Argentina,3,1,1,5,-4,A4,159
B,Ecuador,3,9,4,1,3,B1,159
B,Venezuela,3,4,1,1,0,B2,159
B,Mexico,3,2,2,3,-1,B3,159
B,Jamaica,3,1,1,3,-2,B4,159
C,United States,3,9,7,1,6,C1,159
C,Panama,3,4,3,2,1,C2,159
C,Uruguay,3,4,3,4,-1,C3,159
C,Bolivia,3,0,0,6,-6,C4,159
D,Brazil,3,7,4,1,3,D1,159
D,Colombia,3,5,2,1,1,D2,159
D,Paraguay,3,4,3,2,1,D3,159
D,Costa Rica,3,0,1,6,-5,D4,159
A,Argentina,3,7,9,2,7,A1,160
A,Chile,3,4,5,4,1,A2,160
A,Peru,3,3,3,5,-2,A3,160
A,Canada,3,3,2,8,-6,A4,160
B,Mexico,3,7,3,0,3,B1,160
B,Jamaica,3,4,1,2,-1,B2,160
B,Ecuador,3,3,0,0,0,B3,160
B,Venezuela,3,1,0,2,-2,B4,160
C,United States,3,7,6,2,4,C1,160
C,Uruguay,3,7,5,2,3,C2,160
C,Bolivia,3,1,2,5,-3,C3,160
C,Panama,3,1,2,6,-4,C4,160
D,Colombia,3,7,7,0,7,D1,160
D,Brazil,3,7,4,1,3,D2,160
D,Costa Rica,3,3,4,5,-1,D3,160
D,Paraguay,3,0,0,9,-9,D4,160
A,Argentina,3,9,8,1,7,A1,161
A,Canada,3,6,3,1,2,A2,161
A,Chile,3,3,3,6,-3,A3,161
A,Peru,3,0,1,7,-6,A4,161
B,Ecuador,3,7,4,1,3,B1,161
B,Mexico,3,4,3,3,0,B2,161
B,Venezuela,3,2,2,3,-1,B3,161
B,Jamaica,3,2,1,3,-2,B4,161
C,Uruguay,3,9,6,0,6,C1,161
C,United States,3,6,7,2,5,C2,161
C,Panama,3,3,4,6,-2,C3,161
C,Bolivia,3,0,0,9,-9,C4,161
D,Colombia,3,5,5,4,1,D1,161
D,Brazil,3,4,7,3,4,D2,161
D,Costa Rica,3,4,3,7,-4,D3,161
D,Paraguay,3,2,2,3,-1,D4,161
A,Argentina,3,7,7,1,6,A1,162
A,Canada,3,4,4,6,-2,A2,162
A,Peru,3,3,1,1,0,A3,162
A,Chile,3,1,3,7,-4,A4,162
B,Venezuela,3,9,3,0,3,B1,162
B,Ecuador,3,4,2,1,1,B2,162
B,Mexico,3,4,1,1,0,B3,162
B,Jamaica,3,0,0,4,-4,B4,162
C,United States,3,9,7,2,5,C1,162
C,Uruguay,3,4,7,4,3,C2,162
C,Panama,3,2,5,8,-3,C3,162
C,Bolivia,3,1,2,7,-5,C4,162
D,Colombia,3,9,3,0,3,D1,162
D,Brazil,3,4,1,1,0,D2,162
D,Costa Rica,3,3,2,2,0,D3,162
D,Paraguay,3,1,0,3,-3,D4,162
A,Argentina,3,9,8,3,5,A1,163
A,Chile,3,6,5,4,1,A2,163
A,Canada,3,3,7,7,0,A3,163
A,Peru,3,0,3,9,-6,A4,163
B,Ecuador,3,6,8,5,3,B1,163
B,Mexico,3,6,4,2,2,B2,163
B,Venezuela,3,4,6,6,0,B3,163
B,Jamaica,3,1,2,7,-5,B4,163
C,United States,3,9,9,3,6,C1,163
C,Uruguay,3,4,5,4,1,C2,163
C,Bolivia,3,3,3,6,-3,C3,163
C,Panama,3,1,1,5,-4,C4,163
D,Brazil,3,4,2,2,0,D1,163
D,Costa Rica,3,4,1,1,0,D2,163
D,Paraguay,3,4,1,1,0,D3,163
D,Colombia,3,3,1,1,0,D4,163
A,Argentina,3,9,11,3,8,A1,164
A,Chile,3,4,5,7,-2,A2,164
A,Canada,3,2,3,5,-2,A3,164
A,Peru,3,1,3,7,-4,A4,164
B,Ecuador,3,5,1,0,1,B1,164
B,Mexico,3,4,4,3,1,B2,164
B,Jamaica,3,4,3,3,0,B3,164
B,Venezuela,3,3,3,5,-2,B4,164
C,Uruguay,3,7,6,4,2,C1,164
C,United States,3,6,6,3,3,C2,164
C,Panama,3,4,4,5,-1,C3,164
C,Bolivia,3,0,4,8,-4,C4,164
D,Brazil,3,6,7,4,3,D1,164
D,Costa Rica,3,6,3,2,1,D2,164
D,Colombia,3,3,3,4,-1,D3,164
D,Paraguay,3,3,2,5,-3,D4,164
A,Peru,3,7,3,0,3,A1,165
A,Argentina,3,5,3,1,2,A2,165
A,Chile,3,3,2,5,-3,A3,165
A,Canada,3,1,2,4,-2,A4,165
B,Ecuador,3,9,6,0,6,B1,165
B,Mexico,3,6,7,2,5,B2,165
B,Venezuela,3,3,3,7,-4,B3,165
B,Jamaica,3,0,0,7,-7,B4,165
C,United States,3,5,6,4,2,C1,165
C,Uruguay,3,5,6,4,2,C2,165
C,Bolivia,3,3,2,4,-2,C3,165
C,Panama,3,2,4,6,-2,C4,165
D,Brazil,3,5,3,1,2,D1,165
D,Paraguay,3,4,6,3,3,D2,165
D,Colombia,3,4,2,6,-4,D3,165
D,Costa Rica,3,2,1,2,-1,D4,165
A,Argentina,3,9,5,1,4,A1,166
A,Chile,3,4,4,2,2,A2,166
A,Peru,3,2,1,2,-1,A3,166
A,Canada,3,1,1,6,-5,A4,166
B,Mexico,3,7,4,2,2,B1,166
B,Venezuela,3,4,9,4,5,B2,166
B,Ecuador,3,3,4,5,-1,B3,166
B,Jamaica,3,3,3,9,-6,B4,166
C,United States,3,9,8,1,7,C1,166
C,Uruguay,3,6,2,3,-1,C2,166
C,Bolivia,3,1,1,4,-3,C3,166
C,Panama,3,1,0,3,-3,C4,166
D,Brazil,3,6,7,3,4,D1,166
D,Colombia,3,4,4,4,0,D2,166
D,Paraguay,3,4,1,3,-2,D3,166
D,Costa Rica,3,2,1,3,-2,D4,166
A,Peru,3,7,4,2,2,A1,167
A,Argentina,3,5,4,3,1,A2,167
A,Chile,3,2,2,3,-1,A3,167
A,Canada,3,1,3,5,-2,A4,167
B,Venezuela,3,6,4,3,1,B1,167
B,Ecuador,3,5,1,0,1,B2,167
B,Mexico,3,4,2,2,0,B3,167
B,Jamaica,3,1,3,5,-2,B4,167
C,United States,3,9,7,1,6,C1,167
C,Uruguay,3,6,7,2,5,C2,167
C,Panama,3,1,1,6,-5,C3,167
C,Bolivia,3,1,1,7,-6,C4,167
D,Brazil,3,7,5,1,4,D1,167
D,Colombia,3,4,2,2,0,D2,167
D,Paraguay,3,4,1,1,0,D3,167
D,Costa Rica,3,1,0,4,-4,D4,167
A,Chile,3,5,6,2,4,A1,168
A,Argentina,3,5,3,2,1,A2,168
A,Peru,3,4,2,5,-3,A3,168
A,Canada,3,1,1,3,-2,A4,168
B,Mexico,3,9,5,1,4,B1,168
B,Jamaica,3,6,3,2,1,B2,168
B,Ecuador,3,1,1,3,-2,B3,168
B,Venezuela,3,1,0,3,-3,B4,168
C,Uruguay,3,9,10,3,7,C1,168
C,United States,3,6,6,2,4,C2,168
C,Panama,3,3,4,6,-2,C3,168
C,Bolivia,3,0,3,12,-9,C4,168
D,Brazil,3,9,7,3,4,D1,168
D,Colombia,3,4,3,2,1,D2,168
D,Costa Rica,3,4,2,2,0,D3,168
D,Paraguay,3,0,1,6,-5,D4,168
A,Argentina,3,7,5,1,4,A1,169
A,Chile,3,4,4,5,-1,A2,169
A,Peru,3,3,5,4,1,A3,169
A,Canada,3,3,2,6,-4,A4,169
B,Mexico,3,9,11,2,9,B1,169
B,Jamaica,3,6,2,5,-3,B2,169
B,Ecuador,3,3,2,2,0,B3,169
B,Venezuela,3,0,2,8,-6,B4,169
C,Uruguay,3,5,5,3,2,C1,169
C,Panama,3,4,4,4,0,C2,169
C,United States,3,4,4,4,0,C3,169
C,Bolivia,3,2,1,3,-2,C4,169
D,Brazil,3,9,5,1,4,D1,169
D,Colombia,3,4,4,4,0,D2,169
D,Paraguay,3,4,4,4,0,D3,169
D,Costa Rica,3,0,0,4,-4,D4,169
A,Chile,3,6,3,1,2,A1,170
A,Canada,3,6,2,3,-1,A2,170
A,Peru,3,4,4,2,2,A3,170
A,Argentina,3,1,1,4,-3,A4,170
B,Mexico,3,9,8,1,7,B1,170
B,Ecuador,3,6,3,5,-2,B2,170
B,Venezuela,3,3,1,3,-2,B3,170
B,Jamaica,3,0,2,5,-3,B4,170
C,United States,3,5,3,2,1,C1,170
C,Uruguay,3,5,1,0,1,C2,170
C,Panama,3,4,1,1,0,C3,170
C,Bolivia,3,1,2,4,-2,C4,170
D,Colombia,3,5,4,3,1,D1,170
D,Costa Rica,3,4,4,6,-2,D2,170
D,Paraguay,3,4,3,5,-2,D3,170
D,Brazil,3,3,7,4,3,D4,170
A,Argentina,3,6,5,3,2,A1,171
A,Canada,3,6,4,3,1,A2,171
A,Chile,3,4,4,3,1,A3,171
A,Peru,3,1,0,4,-4,A4,171
B,Mexico,3,6,6,3,3,B1,171
B,Jamaica,3,4,1,1,0,B2,171
B,Venezuela,3,4,4,5,-1,B3,171
B,Ecuador,3,3,3,5,-2,B4,171
C,United States,3,9,11,3,8,C1,171
C,Uruguay,3,4,4,3,1,C2,171
C,Bolivia,3,3,4,7,-3,C3,171
C,Panama,3,1,2,8,-6,C4,171
D,Brazil,3,7,6,1,5,D1,171
D,Colombia,3,3,2,2,0,D2,171
D,Costa Rica,3,2,2,3,-1,D3,171
D,Paraguay,3,2,3,7,-4,D4,171
A,Canada,3,6,4,2,2,A1,172
A,Argentina,3,5,2,1,1,A2,172
A,Chile,3,4,1,1,0,A3,172
A,Peru,3,1,2,5,-3,A4,172
B,Mexico,3,6,9,4,5,B1,172
B,Ecuador,3,6,7,4,3,B2,172
B,Venezuela,3,6,5,4,1,B3,172
B,Jamaica,3,0,1,10,-9,B4,172
C,United States,3,9,5,1,4,C1,172
C,Uruguay,3,6,7,4,3,C2,172
C,Bolivia,3,3,3,5,-2,C3,172
C,Panama,3,0,0,5,-5,C4,172
D,Colombia,3,7,2,0,2,D1,172
D,Brazil,3,5,3,2,1,D2,172
D,Costa Rica,3,4,4,4,0,D3,172
D,Paraguay,3,0,3,6,-3,D4,172
A,Argentina,3,9,11,2,9,A1,173
A,Chile,3,6,6,4,2,A2,173
A,Peru,3,3,4,11,-7,A3,173
A,Canada,3,0,3,7,-4,A4,173
B,Mexico,3,9,7,1,6,B1,173
B,Venezuela,3,6,4,4,0,B2,173
B,Jamaica,3,1,1,4,-3,B3,173
B,Ecuador,3,1,0,3,-3,B4,173
C,Uruguay,3,7,6,2,4,C1,173
C,United States,3,6,5,3,2,C2,173
C,Panama,3,4,3,3,0,C3,173
C,Bolivia,3,0,0,6,-6,C4,173
D,Brazil,3,9,6,0,6,D1,173
D,Costa Rica,3,4,3,3,0,D2,173
D,Colombia,3,2,1,3,-2,D3,173
D,Paraguay,3,1,0,4,-4,D4,173
A,Argentina,3,9,9,0,9,A1,174
A,Chile,3,6,5,1,4,A2,174
A,Canada,3,3,3,11,-8,A3,174
A,Peru,3,0,2,7,-5,A4,174
B,Mexico,3,6,4,3,1,B1,174
B,Venezuela,3,5,5,3,2,B2,174
B,Ecuador,3,2,2,3,-1,B3,174
B,Jamaica,3,2,4,6,-2,B4,174
C,United States,3,7,5,3,2,C1,174
C,Panama,3,5,3,2,1,C2,174
C,Uruguay,3,4,4,4,0,C3,174
C,Bolivia,3,0,2,5,-3,C4,174
D,Brazil,3,9,6,1,5,D1,174
D,Colombia,3,4,7,3,4,D2,174
D,Paraguay,3,4,3,4,-1,D3,174
D,Costa Rica,3,0,1,9,-8,D4,174
A,Argentina,3,9,9,1,8,A1,175
A,Chile,3,6,3,1,2,A2,175
A,Peru,3,1,0,3,-3,A3,175
A,Canada,3,1,1,8,-7,A4,175
B,Mexico,3,9,6,1,5,B1,175
B,Venezuela,3,6,5,4,1,B2,175
B,Ecuador,3,3,2,3,-1,B3,175
B,Jamaica,3,0,2,7,-5,B4,175
C,Uruguay,3,6,12,2,10,C1,175
C,United States,3,6,5,2,3,C2,175
C,Panama,3,3,2,8,-6,C3,175
C,Bolivia,3,3,4,11,-7,C4,175
D,Paraguay,3,7,3,1,2,D1,175
D,Brazil,3,4,4,4,0,D2,175
D,Costa Rica,3,4,4,4,0,D3,175
D,Colombia,3,1,3,5,-2,D4,175
A,Chile,3,6,2,3,-1,A1,176
A,Argentina,3,4,4,2,2,A2,176
A,Canada,3,4,3,3,0,A3,176
A,Peru,3,3,2,3,-1,A4,176
B,Mexico,3,6,7,3,4,B1,176
B,Ecuador,3,6,6,5,1,B2,176
B,Venezuela,3,3,4,5,-1,B3,176
B,Jamaica,3,3,2,6,-4,B4,176
C,United States,3,9,6,2,4,C1,176
C,Uruguay,3,6,5,3,2,C2,176
C,Panama,3,3,1,3,-2,C3,176
C,Bolivia,3,0,0,4,-4,C4,176
D,Brazil,3,7,5,1,4,D1,176
D,Costa Rica,3,4,2,4,-2,D2,176
D,Paraguay,3,3,3,4,-1,D3,176
D,Colombia,3,3,1,2,-1,D4,176
A,Argentina,3,6,7,6,1,A1,177
A,Peru,3,5,4,3,1,A2,177
A,Canada,3,2,3,4,-1,A3,177
A,Chile,3,2,3,4,-1,A4,177
B,Venezuela,3,9,5,2,3,B1,177
B,Mexico,3,4,8,8,0,B2,177
B,Ecuador,3,4,7,7,0,B3,177
B,Jamaica,3,0,1,4,-3,B4,177
C,Uruguay,3,7,9,5,4,C1,177
C,United States,3,5,5,2,3,C2,177
C,Bolivia,3,4,4,6,-2,C3,177
C,Panama,3,0,4,9,-5,C4,177
D,Colombia,3,7,5,1,4,D1,177
D,Brazil,3,7,5,2,3,D2,177
D,Costa Rica,3,3,2,3,-1,D3,177
D,Paraguay,3,0,2,8,-6,D4,177
A,Argentina,3,9,5,2,3,A1,178
A,Chile,3,4,4,4,0,A2,178
A,Canada,3,2,4,5,-1,A3,178
A,Peru,3,1,3,5,-2,A4,178
B,Ecuador,3,7,9,3,6,B1,178
B,Mexico,3,6,4,4,0,B2,178
B,Jamaica,3,3,2,6,-4,B3,178
B,Venezuela,3,1,3,5,-2,B4,178
C,Uruguay,3,9,8,1,7,C1,178
C,United States,3,6,4,3,1,C2,178
C,Panama,3,3,4,4,0,C3,178
C,Bolivia,3,0,0,8,-8,C4,178
D,Brazil,3,7,6,2,4,D1,178
D,Colombia,3,6,5,2,3,D2,178
D,Costa Rica,3,2,3,4,-1,D3,178
D,Paraguay,3,1,1,7,-6,D4,178
A,Argentina,3,9,10,4,6,A1,179
A,Chile,3,6,5,3,2,A2,179
A,Canada,3,1,3,6,-3,A3,179
A,Peru,3,1,1,6,-5,A4,179
B,Ecuador,3,7,5,2,3,B1,179
B,Jamaica,3,4,2,2,0,B2,179
B,Venezuela,3,2,3,4,-1,B3,179
B,Mexico,3,2,1,3,-2,B4,179
C,United States,3,7,5,1,4,C1,179
C,Uruguay,3,4,3,2,1,C2,179
C,Bolivia,3,4,3,4,-1,C3,179
C,Panama,3,1,1,5,-4,C4,179
D,Brazil,3,9,8,1,7,D1,179
D,Paraguay,3,4,3,4,-1,D2,179
D,Colombia,3,3,2,5,-3,D3,179
D,Costa Rica,3,1,0,3,-3,D4,179
A,Argentina,3,7,5,1,4,A1,180
A,Chile,3,6,3,2,1,A2,180
A,Canada,3,4,4,3,1,A3,180
A,Peru,3,0,0,6,-6,A4,180
B,Ecuador,3,6,6,5,1,B1,180
B,Mexico,3,5,5,4,1,B2,180
B,Venezuela,3,4,5,5,0,B3,180
B,Jamaica,3,1,2,4,-2,B4,180
C,Uruguay,3,9,4,0,4,C1,180
C,United States,3,6,3,1,2,C2,180
C,Panama,3,3,3,6,-3,C3,180
C,Bolivia,3,0,2,5,-3,C4,180
D,Brazil,3,7,4,1,3,D1,180
D,Costa Rica,3,6,4,2,2,D2,180
D,Paraguay,3,2,3,5,-2,D3,180
D,Colombia,3,1,2,5,-3,D4,180
A,Argentina,3,7,5,0,5,A1,181
A,Canada,3,6,2,2,0,A2,181
A,Chile,3,2,1,2,-1,A3,181
A,Peru,3,1,1,5,-4,A4,181
B,Mexico,3,7,6,2,4,B1,181
B,Ecuador,3,4,2,2,0,B2,181
B,Jamaica,3,2,3,5,-2,B3,181
B,Venezuela,3,2,1,3,-2,B4,181
C,United States,3,7,8,3,5,C1,181
C,Panama,3,4,3,4,-1,C2,181
C,Bolivia,3,3,4,7,-3,C3,181
C,Uruguay,3,2,3,4,-1,C4,181
D,Brazil,3,4,4,3,1,D1,181
D,Costa Rica,3,4,3,3,0,D2,181
D,Paraguay,3,4,2,3,-1,D3,181
D,Colombia,3,3,1,1,0,D4,181
A,Argentina,3,9,8,1,7,A1,182
A,Canada,3,4,5,5,0,A2,182
A,Peru,3,3,3,7,-4,A3,182
A,Chile,3,1,3,6,-3,A4,182
B,Ecuador,3,6,6,4,2,B1,182
B,Mexico,3,6,6,4,2,B2,182
B,Venezuela,3,3,2,3,-1,B3,182
B,Jamaica,3,3,3,6,-3,B4,182
C,United States,3,6,3,1,2,C1,182
C,Uruguay,3,4,8,3,5,C2,182
C,Bolivia,3,4,7,4,3,C3,182
C,Panama,3,3,1,11,-10,C4,182
D,Brazil,3,9,5,2,3,D1,182
D,Colombia,3,6,4,1,3,D2,182
D,Costa Rica,3,1,2,4,-2,D3,182
D,Paraguay,3,1,2,6,-4,D4,182
A,Chile,3,6,5,2,3,A1,183
A,Canada,3,5,5,4,1,A2,183
A,Peru,3,4,3,3,0,A3,183
A,Argentina,3,1,2,6,-4,A4,183
B,Mexico,3,6,8,5,3,B1,183
B,Ecuador,3,6,5,2,3,B2,183
B,Venezuela,3,6,4,4,0,B3,183
B,Jamaica,3,0,2,8,-6,B4,183
C,Uruguay,3,7,5,1,4,C1,183
C,United States,3,5,4,1,3,C2,183
C,Panama,3,4,6,4,2,C3,183
C,Bolivia,3,0,0,9,-9,C4,183
D,Paraguay,3,5,2,1,1,D1,183
D,Brazil,3,3,4,4,0,D2,183
D,Colombia,3,3,3,3,0,D3,183
D,Costa Rica,3,2,4,5,-1,D4,183
A,Argentina,3,7,7,1,6,A1,184
A,Canada,3,4,4,6,-2,A2,184
A,Peru,3,4,3,5,-2,A3,184
A,Chile,3,1,2,4,-2,A4,184
B,Mexico,3,6,8,4,4,B1,184
B,Ecuador,3,6,5,3,2,B2,184
B,Jamaica,3,3,3,5,-2,B3,184
B,Venezuela,3,3,5,9,-4,B4,184
C,Uruguay,3,9,8,1,7,C1,184
C,United States,3,4,3,5,-2,C2,184
C,Panama,3,3,4,4,0,C3,184
C,Bolivia,3,1,1,6,-5,C4,184
D,Brazil,3,7,6,3,3,D1,184
D,Colombia,3,4,4,4,0,D2,184
D,Paraguay,3,4,3,4,-1,D3,184
D,Costa Rica,3,1,2,4,-2,D4,184
A,Argentina,3,7,6,3,3,A1,185
A,Peru,3,5,6,4,2,A2,185
A,Chile,3,2,4,6,-2,A3,185
A,Canada,3,1,3,6,-3,A4,185
B,Mexico,3,7,7,4,3,B1,185
B,Ecuador,3,6,7,4,3,B2,185
B,Venezuela,3,3,4,7,-3,B3,185
B,Jamaica,3,1,4,7,-3,B4,185
C,United States,3,9,10,2,8,C1,185
C,Bolivia,3,4,5,7,-2,C2,185
C,Uruguay,3,3,5,6,-1,C3,185
C,Panama,3,1,3,8,-5,C4,185
D,Brazil,3,9,6,0,6,D1,185
D,Paraguay,3,4,2,4,-2,D2,185
D,Colombia,3,3,4,4,0,D3,185
D,Costa Rica,3,1,3,7,-4,D4,185
A,Argentina,3,9,9,1,8,A1,186
A,Chile,3,3,4,5,-1,A2,186
A,Peru,3,3,2,5,-3,A3,186
A,Canada,3,3,4,8,-4,A4,186
B,Mexico,3,9,9,3,6,B1,186
B,Venezuela,3,3,4,5,-1,B2,186
B,Ecuador,3,3,8,10,-2,B3,186
B,Jamaica,3,3,4,7,-3,B4,186
C,United States,3,7,8,3,5,C1,186
C,Uruguay,3,4,4,2,2,C2,186
C,Bolivia,3,2,5,8,-3,C3,186
C,Panama,3,2,3,7,-4,C4,186
D,Brazil,3,7,5,0,5,D1,186
D,Colombia,3,6,5,2,3,D2,186
D,Paraguay,3,2,0,3,-3,D3,186
D,Costa Rica,3,1,0,5,-5,D4,186
A,Chile,3,7,4,1,3,A1,187
A,Canada,3,4,2,2,0,A2,187
A,Argentina,3,3,2,2,0,A3,187
A,Peru,3,1,0,3,-3,A4,187
B,Ecuador,3,7,9,5,4,B1,187
B,Mexico,3,6,7,4,3,B2,187
B,Venezuela,3,4,3,4,-1,B3,187
B,Jamaica,3,0,1,7,-6,B4,187
C,United States,3,7,2,0,2,C1,187
C,Uruguay,3,6,5,2,3,C2,187
C,Bolivia,3,3,2,4,-2,C3,187
C,Panama,3,1,0,3,-3,C4,187
D,Brazil,3,7,7,2,5,D1,187
D,Costa Rica,3,6,4,4,0,D2,187
D,Colombia,3,2,3,4,-1,D3,187
D,Paraguay,3,1,1,5,-4,D4,187
A,Argentina,3,6,5,3,2,A1,188
A,Chile,3,6,4,3,1,A2,188
A,Canada,3,4,6,7,-1,A3,188
A,Peru,3,1,2,4,-2,A4,188
B,Mexico,3,7,8,2,6,B1,188
B,Ecuador,3,5,2,1,1,B2,188
B,Venezuela,3,3,2,5,-3,B3,188
B,Jamaica,3,1,3,7,-4,B4,188
C,Uruguay,3,6,8,2,6,C1,188
C,Bolivia,3,6,6,4,2,C2,188
C,United States,3,6,4,5,-1,C3,188
C,Panama,3,0,2,9,-7,C4,188
D,Brazil,3,9,8,2,6,D1,188
D,Paraguay,3,4,3,4,-1,D2,188
D,Colombia,3,2,1,2,-1,D3,188
D,Costa Rica,3,1,2,6,-4,D4,188
A,Argentina,3,9,5,1,4,A1,189
A,Peru,3,4,5,3,2,A2,189
A,Chile,3,3,3,6,-3,A3,189
A,Canada,3,1,3,6,-3,A4,189
B,Mexico,3,9,5,2,3,B1,189
B,Ecuador,3,4,3,3,0,B2,189
B,Venezuela,3,2,1,2,-1,B3,189
B,Jamaica,3,1,1,3,-2,B4,189
C,United States,3,5,4,1,3,C1,189
C,Uruguay,3,3,3,3,0,C2,189
C,Bolivia,3,3,2,2,0,C3,189
C,Panama,3,2,2,5,-3,C4,189
D,Brazil,3,7,4,0,4,D1,189
D,Colombia,3,7,4,0,4,D2,189
D,Costa Rica,3,1,0,4,-4,D3,189
D,Paraguay,3,1,0,4,-4,D4,189
A,Argentina,3,7,6,2,4,A1,190
A,Canada,3,4,6,6,0,A2,190
A,Chile,3,4,4,5,-1,A3,190
A,Peru,3,1,3,6,-3,A4,190
B,Ecuador,3,7,5,2,3,B1,190
B,Venezuela,3,6,5,3,2,B2,190
B,Mexico,3,4,3,2,1,B3,190
B,Jamaica,3,0,1,7,-6,B4,190
C,United States,3,7,7,2,5,C1,190
C,Bolivia,3,4,4,6,-2,C2,190
C,Uruguay,3,3,4,4,0,C3,190
C,Panama,3,1,3,6,-3,C4,190
D,Brazil,3,9,6,2,4,D1,190
D,Colombia,3,6,7,3,4,D2,190
D,Paraguay,3,3,5,5,0,D3,190
D,Costa Rica,3,0,2,10,-8,D4,190
A,Chile,3,5,5,4,1,A1,191
A,Argentina,3,4,6,2,4,A2,191
A,Peru,3,4,3,3,0,A3,191
A,Canada,3,2,1,6,-5,A4,191
B,Ecuador,3,7,4,1,3,B1,191
B,Venezuela,3,6,7,5,2,B2,191
B,Mexico,3,4,3,4,-1,B3,191
B,Jamaica,3,0,2,6,-4,B4,191
C,United States,3,7,8,1,7,C1,191
C,Uruguay,3,6,8,4,4,C2,191
C,Panama,3,3,6,12,-6,C3,191
C,Bolivia,3,1,0,5,-5,C4,191
D,Colombia,3,6,5,3,2,D1,191
D,Paraguay,3,6,2,4,-2,D2,191
D,Brazil,3,4,6,4,2,D3,191
D,Costa Rica,3,1,4,6,-2,D4,191
A,Argentina,3,9,6,2,4,A1,192
A,Peru,3,4,4,4,0,A2,192
A,Chile,3,2,4,5,-1,A3,192
A,Canada,3,1,5,8,-3,A4,192
B,Mexico,3,6,7,3,4,B1,192
B,Jamaica,3,6,6,4,2,B2,192
B,Ecuador,3,3,4,7,-3,B3,192
B,Venezuela,3,3,3,6,-3,B4,192
C,Uruguay,3,7,6,1,5,C1,192
C,United States,3,4,1,1,0,C2,192
C,Panama,3,4,3,5,-2,C3,192
C,Bolivia,3,1,2,5,-3,C4,192
D,Brazil,3,7,4,1,3,D1,192
D,Colombia,3,6,5,2,3,D2,192
D,Paraguay,3,3,2,4,-2,D3,192
D,Costa Rica,3,1,1,5,-4,D4,192
A,Peru,3,5,5,4,1,A1,193
A,Argentina,3,4,6,4,2,A2,193
A,Canada,3,3,5,5,0,A3,193
A,Chile,3,2,2,5,-3,A4,193
B,Venezuela,3,6,4,2,2,B1,193
B,Ecuador,3,4,3,2,1,B2,193
B,Mexico,3,4,3,3,0,B3,193
B,Jamaica,3,2,3,6,-3,B4,193
C,United States,3,9,7,2,5,C1,193
C,Uruguay,3,6,6,3,3,C2,193
C,Bolivia,3,3,5,7,-2,C3,193
C,Panama,3,0,2,8,-6,C4,193
D,Brazil,3,7,5,1,4,D1,193
D,Colombia,3,5,4,1,3,D2,193
D,Costa Rica,3,3,1,6,-5,D3,193
D,Paraguay,3,1,0,2,-2,D4,193
A,Argentina,3,7,11,6,5,A1,194
A,Canada,3,4,8,9,-1,A2,194
A,Peru,3,4,3,4,-1,A3,194
A,Chile,3,1,6,9,-3,A4,194
B,Jamaica,3,7,3,1,2,B1,194
B,Mexico,3,6,4,2,2,B2,194
B,Venezuela,3,2,1,2,-1,B3,194
B,Ecuador,3,1,1,4,-3,B4,194
C,Uruguay,3,9,4,1,3,C1,194
C,United States,3,4,3,2,1,C2,194
C,Bolivia,3,3,4,5,-1,C3,194
C,Panama,3,1,2,5,-3,C4,194
D,Brazil,3,9,10,2,8,D1,194
D,Colombia,3,4,5,4,1,D2,194
D,Paraguay,3,3,2,6,-4,D3,194
D,Costa Rica,3,1,1,6,-5,D4,194
A,Peru,3,6,3,2,1,A1,195
A,Chile,3,4,5,3,2,A2,195
A,Canada,3,4,4,4,0,A3,195
A,Argentina,3,3,3,6,-3,A4,195
B,Venezuela,3,6,4,3,1,B1,195
B,Ecuador,3,6,3,3,0,B2,195
B,Mexico,3,4,3,2,1,B3,195
B,Jamaica,3,1,0,2,-2,B4,195
C,Uruguay,3,7,5,1,4,C1,195
C,United States,3,4,5,5,0,C2,195
C,Panama,3,3,5,6,-1,C3,195
C,Bolivia,3,3,4,7,-3,C4,195
D,Colombia,3,6,6,4,2,D1,195
D,Brazil,3,6,4,2,2,D2,195
D,Paraguay,3,4,4,4,0,D3,195
D,Costa Rica,3,1,2,6,-4,D4,195
A,Argentina,3,7,14,2,12,A1,196
A,Peru,3,4,3,4,-1,A2,196
A,Chile,3,4,3,5,-2,A3,196
A,Canada,3,1,1,10,-9,A4,196
B,Jamaica,3,7,4,2,2,B1,196
B,Venezuela,3,4,4,2,2,B2,196
B,Ecuador,3,3,2,5,-3,B3,196
B,Mexico,3,2,2,3,-1,B4,196
C,Uruguay,3,9,7,0,7,C1,196
C,United States,3,6,7,3,4,C2,196
C,Bolivia,3,3,3,6,-3,C3,196
C,Panama,3,0,0,8,-8,C4,196
D,Brazil,3,7,3,0,3,D1,196
D,Paraguay,3,6,5,3,2,D2,196
D,Colombia,3,4,3,2,1,D3,196
D,Costa Rica,3,0,0,6,-6,D4,196
A,Chile,3,9,4,0,4,A1,197
A,Argentina,3,6,7,2,5,A2,197
A,Canada,3,3,2,5,-3,A3,197
A,Peru,3,0,0,6,-6,A4,197
B,Ecuador,3,5,2,1,1,B1,197
B,Venezuela,3,4,3,3,0,B2,197
B,Mexico,3,4,1,1,0,B3,197
B,Jamaica,3,2,3,4,-1,B4,197
C,Panama,3,5,5,2,3,C1,197
C,Bolivia,3,5,1,0,1,C2,197
C,United States,3,3,3,5,-2,C3,197
C,Uruguay,3,2,1,3,-2,C4,197
D,Brazil,3,5,4,1,3,D1,197
D,Paraguay,3,5,3,1,2,D2,197
D,Colombia,3,3,0,0,0,D3,197
D,Costa Rica,3,1,0,5,-5,D4,197
A,Peru,3,6,7,3,4,A1,198
A,Argentina,3,6,6,3,3,A2,198
A,Chile,3,6,6,5,1,A3,198
A,Canada,3,0,1,9,-8,A4,198
B,Mexico,3,6,5,2,3,B1,198
B,Ecuador,3,4,3,2,1,B2,198
B,Jamaica,3,4,2,4,-2,B3,198
B,Venezuela,3,2,2,4,-2,B4,198
C,United States,3,7,8,5,3,C1,198
C,Bolivia,3,4,4,4,0,C2,198
C,Uruguay,3,3,5,7,-2,C3,198
C,Panama,3,2,4,5,-1,C4,198
D,Brazil,3,5,3,1,2,D1,198
D,Colombia,3,5,3,2,1,D2,198
D,Paraguay,3,2,1,2,-1,D3,198
D,Costa Rica,3,2,0,2,-2,D4,198
A,Argentina,3,7,6,2,4,A1,199
A,Canada,3,7,5,1,4,A2,199
A,Chile,3,3,1,4,-3,A3,199
A,Peru,3,0,1,6,-5,A4,199
B,Ecuador,3,9,4,1,3,B1,199
B,Mexico,3,6,7,4,3,B2,199
B,Venezuela,3,3,5,5,0,B3,199
B,Jamaica,3,0,2,8,-6,B4,199
C,United States,3,9,6,0,6,C1,199
C,Uruguay,3,6,6,3,3,C2,199
C,Bolivia,3,3,3,6,-3,C3,199
C,Panama,3,0,1,7,-6,C4,199
D,Brazil,3,7,6,2,4,D1,199
D,Colombia,3,4,3,2,1,D2,199
D,Costa Rica,3,4,2,4,-2,D3,199
D,Paraguay,3,1,2,5,-3,D4,199
A,Argentina,3,7,5,1,4,A1,200
A,Chile,3,4,3,4,-1,A2,200
A,Peru,3,2,3,4,-1,A3,200
A,Canada,3,2,2,4,-2,A4,200
B,Venezuela,3,9,8,0,8,B1,200
B,Mexico,3,6,5,7,-2,B2,200
B,Ecuador,3,1,4,7,-3,B3,200
B,Jamaica,3,1,2,5,-3,B4,200
C,Uruguay,3,9,6,2,4,C1,200
C,United States,3,6,5,3,2,C2,200
C,Bolivia,3,1,1,3,-2,C3,200
C,Panama,3,1,1,5,-4,C4,200
D,Brazil,3,6,4,2,2,D1,200
D,Colombia,3,6,4,3,1,D2,200
D,Paraguay,3,4,4,5,-1,D3,200
D,Costa Rica,3,1,2,4,-2,D4,200
A,Argentina,3,7,4,0,4,A1,201
A,Chile,3,5,3,2,1,A2,201
A,Peru,3,4,3,4,-1,A3,201
A,Canada,3,0,2,6,-4,A4,201
B,Ecuador,3,7,4,1,3,B1,201
B,Mexico,3,5,2,1,1,B2,201
B,Venezuela,3,4,2,3,-1,B3,201
B,Jamaica,3,0,1,4,-3,B4,201
C,Uruguay,3,7,9,2,7,C1,201
C,Bolivia,3,5,6,4,2,C2,201
C,Panama,3,3,1,6,-5,C3,201
C,United States,3,1,2,6,-4,C4,201
D,Brazil,3,6,7,6,1,D1,201
D,Paraguay,3,4,6,4,2,D2,201
D,Colombia,3,4,3,4,-1,D3,201
D,Costa Rica,3,2,2,4,-2,D4,201
A,Argentina,3,9,9,2,7,A1,202
A,Peru,3,6,7,4,3,A2,202
A,Chile,3,3,7,5,2,A3,202
A,Canada,3,0,1,13,-12,A4,202
B,Ecuador,3,9,9,2,7,B1,202
B,Venezuela,3,4,2,2,0,B2,202
B,Mexico,3,2,4,8,-4,B3,202
B,Jamaica,3,1,2,5,-3,B4,202
C,United States,3,9,7,2,5,C1,202
C,Uruguay,3,6,9,3,6,C2,202
C,Bolivia,3,3,4,7,-3,C3,202
C,Panama,3,0,1,9,-8,C4,202
D,Colombia,3,9,4,0,4,D1,202
D,Brazil,3,6,3,2,1,D2,202
D,Costa Rica,3,3,3,5,-2,D3,202
D,Paraguay,3,0,1,4,-3,D4,202
A,Canada,3,7,4,2,2,A1,203
A,Argentina,3,5,4,3,1,A2,203
A,Chile,3,2,3,4,-1,A3,203
A,Peru,3,1,2,4,-2,A4,203
B,Ecuador,3,9,7,2,5,B1,203
B,Venezuela,3,4,4,5,-1,B2,203
B,Jamaica,3,2,3,5,-2,B3,203
B,Mexico,3,1,2,4,-2,B4,203
C,United States,3,7,13,3,10,C1,203
C,Bolivia,3,4,4,7,-3,C2,203
C,Uruguay,3,3,4,4,0,C3,203
C,Panama,3,1,3,10,-7,C4,203
D,Colombia,3,5,4,3,1,D1,203
D,Paraguay,3,5,4,3,1,D2,203
D,Brazil,3,4,3,2,1,D3,203
D,Costa Rica,3,1,1,4,-3,D4,203
A,Argentina,3,6,5,1,4,A1,204
A,Canada,3,4,1,1,0,A2,204
A,Chile,3,4,1,1,0,A3,204
A,Peru,3,2,0,4,-4,A4,204
B,Ecuador,3,9,7,2,5,B1,204
B,Venezuela,3,6,2,2,0,B2,204
B,Mexico,3,3,3,4,-1,B3,204
B,Jamaica,3,0,1,5,-4,B4,204
C,United States,3,7,6,3,3,C1,204
C,Bolivia,3,6,5,3,2,C2,204
C,Uruguay,3,4,2,2,0,C3,204
C,Panama,3,0,1,6,-5,C4,204
D,Brazil,3,9,8,3,5,D1,204
D,Colombia,3,6,5,4,1,D2,204
D,Costa Rica,3,1,1,3,-2,D3,204
D,Paraguay,3,1,3,7,-4,D4,204
A,Chile,3,7,3,1,2,A1,205
A,Argentina,3,4,3,2,1,A2,205
A,Canada,3,3,4,5,-1,A3,205
A,Peru,3,3,3,5,-2,A4,205
B,Mexico,3,7,10,7,3,B1,205
B,Venezuela,3,5,4,2,2,B2,205
B,Jamaica,3,3,6,8,-2,B3,205
B,Ecuador,3,1,3,6,-3,B4,205
C,Panama,3,9,4,1,3,C1,205
C,Uruguay,3,4,6,2,4,C2,205
C,United States,3,4,6,5,1,C3,205
C,Bolivia,3,0,2,10,-8,C4,205
D,Brazil,3,9,6,1,5,D1,205
D,Colombia,3,4,3,3,0,D2,205
D,Costa Rica,3,2,1,3,-2,D3,205
D,Paraguay,3,1,4,7,-3,D4,205
A,Canada,3,5,3,2,1,A1,206
A,Chile,3,4,3,4,-1,A2,206
A,Peru,3,4,3,4,-1,A3,206
A,Argentina,3,3,4,3,1,A4,206
B,Venezuela,3,7,7,2,5,B1,206
B,Mexico,3,4,2,2,0,B2,206
B,Ecuador,3,3,4,6,-2,B3,206
B,Jamaica,3,3,2,5,-3,B4,206
C,United States,3,5,4,3,1,C1,206
C,Uruguay,3,4,7,5,2,C2,206
C,Bolivia,3,4,3,3,0,C3,206
C,Panama,3,3,2,5,-3,C4,206
D,Brazil,3,6,9,4,5,D1,206
D,Paraguay,3,6,6,4,2,D2,206
D,Colombia,3,4,3,3,0,D3,206
D,Costa Rica,3,1,1,8,-7,D4,206
A,Chile,3,9,6,3,3,A1,207
A,Argentina,3,6,12,7,5,A2,207
A,Canada,3,3,4,7,-3,A3,207
A,Peru,3,0,4,9,-5,A4,207
B,Mexico,3,6,6,4,2,B1,207
B,Ecuador,3,6,5,3,2,B2,207
B,Venezuela,3,3,2,3,-1,B3,207
B,Jamaica,3,3,2,5,-3,B4,207
C,Panama,3,5,5,4,1,C1,207
C,Uruguay,3,5,5,4,1,C2,207
C,United States,3,3,4,4,0,C3,207
C,Bolivia,3,2,2,4,-2,C4,207
D,Brazil,3,9,13,2,11,D1,207
D,Colombia,3,6,8,3,5,D2,207
D,Paraguay,3,1,0,5,-5,D3,207
D,Costa Rica,3,1,1,12,-11,D4,207
A,Peru,3,7,6,2,4,A1,208
A,Argentina,3,6,6,2,4,A2,208
A,Chile,3,3,2,5,-3,A3,208
A,Canada,3,1,1,6,-5,A4,208
B,Ecuador,3,7,3,1,2,B1,208
B,Jamaica,3,4,3,4,-1,B2,208
B,Venezuela,3,3,3,3,0,B3,208
B,Mexico,3,3,2,3,-1,B4,208
C,United States,3,7,6,1,5,C1,208
C,Uruguay,3,5,4,2,2,C2,208
C,Bolivia,3,4,1,3,-2,C3,208
C,Panama,3,0,1,6,-5,C4,208
D,Brazil,3,7,10,2,8,D1,208
D,Paraguay,3,5,5,1,4,D2,208
D,Colombia,3,4,1,5,-4,D3,208
D,Costa Rica,3,0,1,9,-8,D4,208
A,Argentina,3,9,11,2,9,A1,209
A,Chile,3,6,5,4,1,A2,209
A,Peru,3,3,6,8,-2,A3,209
A,Canada,3,0,3,11,-8,A4,209
B,Ecuador,3,7,5,2,3,B1,209
B,Mexico,3,4,3,4,-1,B2,209
B,Jamaica,3,3,3,4,-1,B3,209
B,Venezuela,3,2,2,3,-1,B4,209
C,Bolivia,3,6,5,5,0,C1,209
C,Uruguay,3,4,5,2,3,C2,209
C,United States,3,4,4,3,1,C3,209
C,Panama,3,3,4,8,-4,C4,209
D,Brazil,3,9,8,0,8,D1,209
D,Colombia,3,6,4,2,2,D2,209
D,Costa Rica,3,3,3,9,-6,D3,209
D,Paraguay,3,0,1,5,-4,D4,209
A,Argentina,3,7,6,3,3,A1,210
A,Chile,3,5,4,2,2,A2,210
A,Canada,3,4,3,4,-1,A3,210
A,Peru,3,0,3,7,-4,A4,210
B,Mexico,3,7,6,1,5,B1,210
B,Ecuador,3,4,4,4,0,B2,210
B,Venezuela,3,3,3,5,-2,B3,210
B,Jamaica,3,3,3,6,-3,B4,210
C,United States,3,9,8,3,5,C1,210
C,Uruguay,3,6,5,3,2,C2,210
C,Bolivia,3,3,1,3,-2,C3,210
C,Panama,3,0,1,6,-5,C4,210
D,Brazil,3,7,10,3,7,D1,210
D,Paraguay,3,4,4,4,0,D2,210
D,Colombia,3,4,2,3,-1,D3,210
D,Costa Rica,3,1,1,7,-6,D4,210
A,Argentina,3,7,9,0,9,A1,211
A,Chile,3,4,4,6,-2,A2,211
A,Canada,3,3,1,1,0,A3,211
A,Peru,3,1,1,8,-7,A4,211
B,Mexico,3,7,6,2,4,B1,211
B,Venezuela,3,5,5,3,2,B2,211
B,Jamaica,3,4,4,5,-1,B3,211
B,Ecuador,3,0,2,7,-5,B4,211
C,Uruguay,3,7,5,2,3,C1,211
C,Panama,3,4,2,2,0,C2,211
C,United States,3,3,1,3,-2,C3,211
C,Bolivia,3,2,1,2,-1,C4,211
D,Brazil,3,6,8,2,6,D1,211
D,Colombia,3,5,2,1,1,D2,211
D,Costa Rica,3,4,1,5,-4,D3,211
D,Paraguay,3,1,2,5,-3,D4,211
A,Argentina,3,7,8,3,5,A1,212
A,Peru,3,4,2,4,-2,A2,212
A,Chile,3,3,2,2,0,A3,212
A,Canada,3,1,4,7,-3,A4,212
B,Mexico,3,6,9,2,7,B1,212
B,Ecuador,3,6,5,7,-2,B2,212
B,Venezuela,3,3,3,4,-1,B3,212
B,Jamaica,3,3,1,5,-4,B4,212
C,Uruguay,3,7,5,1,4,C1,212
C,Panama,3,6,4,4,0,C2,212
C,United States,3,3,5,6,-1,C3,212
C,Bolivia,3,1,2,5,-3,C4,212
D,Brazil,3,7,7,2,5,D1,212
D,Paraguay,3,7,3,1,2,D2,212
D,Colombia,3,3,5,7,-2,D3,212
D,Costa Rica,3,0,2,7,-5,D4,212
A,Peru,3,6,3,2,1,A1,213
A,Argentina,3,5,3,2,1,A2,213
A,Chile,3,2,6,7,-1,A3,213
A,Canada,3,2,5,6,-1,A4,213
B,Venezuela,3,9,5,0,5,B1,213
B,Ecuador,3,6,3,1,2,B2,213
B,Mexico,3,1,0,3,-3,B3,213
B,Jamaica,3,1,0,4,-4,B4,213
C,Uruguay,3,7,9,4,5,C1,213
C,United States,3,7,5,1,4,C2,213
C,Bolivia,3,3,4,6,-2,C3,213
C,Panama,3,0,0,7,-7,C4,213
D,Brazil,3,9,9,4,5,D1,213
D,Colombia,3,4,4,3,1,D2,213
D,Costa Rica,3,3,5,8,-3,D3,213
D,Paraguay,3,1,2,5,-3,D4,213
A,Argentina,3,7,10,2,8,A1,214
A,Peru,3,4,2,5,-3,A2,214
A,Canada,3,2,1,2,-1,A3,214
A,Chile,3,2,2,6,-4,A4,214
B,Mexico,3,9,6,1,5,B1,214
B,Venezuela,3,3,3,3,0,B2,214
B,Ecuador,3,3,4,5,-1,B3,214
B,Jamaica,3,3,3,7,-4,B4,214
C,Panama,3,6,3,4,-1,C1,214
C,Bolivia,3,4,5,5,0,C2,214
C,United States,3,4,4,4,0,C3,214
C,Uruguay,3,3,7,6,1,C4,214
D,Brazil,3,6,8,2,6,D1,214
D,Paraguay,3,5,4,3,1,D2,214
D,Colombia,3,2,2,4,-2,D3,214
D,Costa Rica,3,2,2,7,-5,D4,214
A,Argentina,3,9,7,1,6,A1,215
A,Chile,3,4,4,5,-1,A2,215
A,Canada,3,3,2,5,-3,A3,215
A,Peru,3,1,2,4,-2,A4,215
B,Venezuela,3,9,7,1,6,B1,215
B,Mexico,3,6,6,2,4,B2,215
B,Ecuador,3,3,4,4,0,B3,215
B,Jamaica,3,0,0,10,-10,B4,215
C,United States,3,9,4,0,4,C1,215
C,Uruguay,3,6,3,1,2,C2,215
C,Bolivia,3,1,1,3,-2,C3,215
C,Panama,3,1,1,5,-4,C4,215
D,Colombia,3,7,8,4,4,D1,215
D,Brazil,3,6,6,5,1,D2,215
D,Costa Rica,3,2,3,5,-2,D3,215
D,Paraguay,3,1,2,5,-3,D4,215
A,Argentina,3,7,6,0,6,A1,216
A,Peru,3,3,1,1,0,A2,216
A,Chile,3,2,1,3,-2,A3,216
A,Canada,3,2,2,6,-4,A4,216
B,Ecuador,3,9,7,3,4,B1,216
B,Mexico,3,4,5,5,0,B2,216
B,Venezuela,3,4,2,3,-1,B3,216
B,Jamaica,3,0,0,3,-3,B4,216
C,Uruguay,3,6,4,3,1,C1,216
C,United States,3,5,6,4,2,C2,216
C,Panama,3,2,2,3,-1,C3,216
C,Bolivia,3,2,3,5,-2,C4,216
D,Brazil,3,7,4,1,3,D1,216
D,Colombia,3,6,6,2,4,D2,216
D,Paraguay,3,4,4,4,0,D3,216
D,Costa Rica,3,0,1,8,-7,D4,216
A,Chile,3,7,4,1,3,A1,217
A,Peru,3,4,3,4,-1,A2,217
A,Canada,3,3,2,3,-1,A3,217
A,Argentina,3,2,2,3,-1,A4,217
B,Venezuela,3,7,5,3,2,B1,217
B,Mexico,3,4,5,4,1,B2,217
B,Ecuador,3,3,4,4,0,B3,217
B,Jamaica,3,2,3,6,-3,B4,217
C,Uruguay,3,9,5,1,4,C1,217
C,Bolivia,3,4,3,4,-1,C2,217
C,United States,3,3,4,2,2,C3,217
C,Panama,3,1,3,8,-5,C4,217
D,Brazil,3,9,6,0,6,D1,217
D,Colombia,3,4,3,4,-1,D2,217
D,Costa Rica,3,2,0,3,-3,D3,217
D,Paraguay,3,1,2,4,-2,D4,217
A,Argentina,3,9,6,0,6,A1,218
A,Chile,3,6,5,7,-2,A2,218
A,Peru,3,3,5,4,1,A3,218
A,Canada,3,0,3,8,-5,A4,218
B,Venezuela,3,9,6,2,4,B1,218
B,Mexico,3,6,5,4,1,B2,218
B,Ecuador,3,1,2,4,-2,B3,218
B,Jamaica,3,1,2,5,-3,B4,218
C,Uruguay,3,7,8,2,6,C1,218
C,United States,3,6,4,4,0,C2,218
C,Panama,3,2,2,4,-2,C3,218
C,Bolivia,3,1,1,5,-4,C4,218
D,Brazil,3,9,9,1,8,D1,218
D,Colombia,3,6,4,5,-1,D2,218
D,Paraguay,3,1,2,4,-2,D3,218
D,Costa Rica,3,1,5,10,-5,D4,218
A,Argentina,3,7,8,3,5,A1,219
A,Chile,3,4,4,5,-1,A2,219
A,Canada,3,3,5,8,-3,A3,219
A,Peru,3,2,2,3,-1,A4,219
B,Venezuela,3,6,4,3,1,B1,219
B,Jamaica,3,4,4,3,1,B2,219
B,Mexico,3,4,1,2,-1,B3,219
B,Ecuador,3,3,4,5,-1,B4,219
C,United States,3,9,9,3,6,C1,219
C,Uruguay,3,4,2,1,1,C2,219
C,Panama,3,4,4,5,-1,C3,219
C,Bolivia,3,0,1,7,-6,C4,219
D,Brazil,3,9,10,0,10,D1,219
D,Paraguay,3,4,3,7,-4,D2,219
D,Colombia,3,3,5,3,2,D3,219
D,Costa Rica,3,1,1,9,-8,D4,219
A,Argentina,3,7,4,1,3,A1,220
A,Canada,3,5,3,1,2,A2,220
A,Chile,3,3,3,5,-2,A3,220
A,Peru,3,1,0,3,-3,A4,220
B,Venezuela,3,6,5,3,2,B1,220
B,Mexico,3,4,5,5,0,B2,220
B,Jamaica,3,4,6,7,-1,B3,220
B,Ecuador,3,3,6,7,-1,B4,220
C,Uruguay,3,9,11,2,9,C1,220
C,United States,3,6,6,3,3,C2,220
C,Panama,3,3,5,9,-4,C3,220
C,Bolivia,3,0,1,9,-8,C4,220
D,Colombia,3,7,6,2,4,D1,220
D,Brazil,3,4,2,2,0,D2,220
D,Paraguay,3,3,2,3,-1,D3,220
D,Costa Rica,3,3,1,4,-3,D4,220
A,Argentina,3,9,7,2,5,A1,221
A,Canada,3,6,5,4,1,A2,221
A,Peru,3,3,2,3,-1,A3,221
A,Chile,3,0,2,7,-5,A4,221
B,Venezuela,3,5,5,1,4,B1,221
B,Ecuador,3,5,6,4,2,B2,221
B,Mexico,3,3,3,3,0,B3,221
B,Jamaica,3,1,2,8,-6,B4,221
C,United States,3,9,6,3,3,C1,221
C,Panama,3,4,4,4,0,C2,221
C,Uruguay,3,4,3,3,0,C3,221
C,Bolivia,3,0,6,9,-3,C4,221
D,Brazil,3,7,4,0,4,D1,221
D,Costa Rica,3,4,3,5,-2,D2,221
D,Paraguay,3,3,3,3,0,D3,221
D,Colombia,3,1,1,3,-2,D4,221
A,Argentina,3,9,7,1,6,A1,222
A,Canada,3,4,2,2,0,A2,222
A,Peru,3,3,2,5,-3,A3,222
A,Chile,3,1,2,5,-3,A4,222
B,Venezuela,3,6,3,2,1,B1,222
B,Jamaica,3,5,3,2,1,B2,222
B,Ecuador,3,4,3,3,0,B3,222
B,Mexico,3,1,3,5,-2,B4,222
C,Panama,3,9,4,1,3,C1,222
C,Uruguay,3,6,4,2,2,C2,222
C,United States,3,3,5,3,2,C3,222
C,Bolivia,3,0,1,8,-7,C4,222
D,Colombia,3,7,10,4,6,D1,222
D,Brazil,3,6,11,3,8,D2,222
D,Paraguay,3,2,3,9,-6,D3,222
D,Costa Rica,3,1,3,11,-8,D4,222
A,Argentina,3,7,7,0,7,A1,223
A,Chile,3,5,6,1,5,A2,223
A,Canada,3,3,1,11,-10,A3,223
A,Peru,3,1,1,3,-2,A4,223
B,Venezuela,3,7,5,1,4,B1,223
B,Ecuador,3,4,2,2,0,B2,223
B,Mexico,3,3,0,0,0,B3,223
B,Jamaica,3,1,1,5,-4,B4,223
C,United States,3,5,5,1,4,C1,223
C,Uruguay,3,5,6,3,3,C2,223
C,Bolivia,3,3,6,11,-5,C3,223
C,Panama,3,2,4,6,-2,C4,223
D,Brazil,3,9,9,1,8,D1,223
D,Colombia,3,6,3,4,-1,D2,223
D,Costa Rica,3,1,3,5,-2,D3,223
D,Paraguay,3,1,1,6,-5,D4,223
A,Canada,3,6,7,3,4,A1,224
A,Argentina,3,6,7,6,1,A2,224
A,Chile,3,3,4,5,-1,A3,224
A,Peru,3,3,5,9,-4,A4,224
B,Jamaica,3,7,3,1,2,B1,224
B,Venezuela,3,4,3,2,1,B2,224
B,Ecuador,3,4,2,3,-1,B3,224
B,Mexico,3,1,1,3,-2,B4,224
C,United States,3,7,6,1,5,C1,224
C,Panama,3,6,4,4,0,C2,224
C,Uruguay,3,3,4,7,-3,C3,224
C,Bolivia,3,1,4,6,-2,C4,224
D,Brazil,3,7,7,2,5,D1,224
D,Colombia,3,4,5,4,1,D2,224
D,Paraguay,3,3,3,5,-2,D3,224
D,Costa Rica,3,3,4,8,-4,D4,224
A,Argentina,3,7,8,0,8,A1,225
A,Chile,3,6,3,4,-1,A2,225
A,Canada,3,3,2,5,-3,A3,225
A,Peru,3,1,0,4,-4,A4,225
B,Mexico,3,7,5,1,4,B1,225
B,Ecuador,3,4,5,3,2,B2,225
B,Jamaica,3,3,2,4,-2,B3,225
B,Venezuela,3,3,1,5,-4,B4,225
C,United States,3,7,4,1,3,C1,225
C,Bolivia,3,4,2,2,0,C2,225
C,Uruguay,3,3,3,3,0,C3,225
C,Panama,3,1,1,4,-3,C4,225
D,Brazil,3,7,4,0,4,D1,225
D,Colombia,3,6,2,1,1,D2,225
D,Paraguay,3,3,2,5,-3,D3,225
D,Costa Rica,3,1,1,3,-2,D4,225
A,Argentina,3,7,7,5,2,A1,226
A,Chile,3,5,3,2,1,A2,226
A,Canada,3,3,4,4,0,A3,226
A,Peru,3,1,1,4,-3,A4,226
B,Ecuador,3,9,6,1,5,B1,226
B,Mexico,3,4,5,4,1,B2,226
B,Venezuela,3,3,4,6,-2,B3,226
B,Jamaica,3,1,5,9,-4,B4,226
C,Uruguay,3,9,4,0,4,C1,226
C,United States,3,6,6,1,5,C2,226
C,Bolivia,3,3,2,5,-3,C3,226
C,Panama,3,0,0,6,-6,C4,226
D,Colombia,3,5,4,1,3,D1,226
D,Costa Rica,3,5,1,0,1,D2,226
D,Brazil,3,4,3,2,1,D3,226
D,Paraguay,3,1,0,5,-5,D4,226
A,Argentina,3,9,6,1,5,A1,227
A,Peru,3,4,4,2,2,A2,227
A,Canada,3,2,0,3,-3,A3,227
A,Chile,3,1,0,4,-4,A4,227
B,Ecuador,3,6,3,1,2,B1,227
B,Mexico,3,6,4,3,1,B2,227
B,Venezuela,3,3,2,3,-1,B3,227
B,Jamaica,3,3,1,3,-2,B4,227
C,Uruguay,3,7,7,2,5,C1,227
C,United States,3,5,5,4,1,C2,227
C,Panama,3,3,2,3,-1,C3,227
C,Bolivia,3,1,2,7,-5,C4,227
D,Brazil,3,9,7,0,7,D1,227
D,Colombia,3,6,5,2,3,D2,227
D,Paraguay,3,3,2,5,-3,D3,227
D,Costa Rica,3,0,0,7,-7,D4,227
A,Argentina,3,5,4,2,2,A1,228
A,Chile,3,4,3,3,0,A2,228
A,Peru,3,4,3,3,0,A3,228
A,Canada,3,3,3,5,-2,A4,228
B,Ecuador,3,6,2,1,1,B1,228
B,Jamaica,3,5,3,2,1,B2,228
B,Mexico,3,4,7,2,5,B3,228
B,Venezuela,3,1,1,8,-7,B4,228
C,Uruguay,3,7,9,2,7,C1,228
C,United States,3,7,8,1,7,C2,228
C,Panama,3,3,2,6,-4,C3,228
C,Bolivia,3,0,1,11,-10,C4,228
D,Brazil,3,9,7,1,6,D1,228
D,Colombia,3,4,3,2,1,D2,228
D,Paraguay,3,4,3,2,1,D3,228
D,Costa Rica,3,0,1,9,-8,D4,228
A,Argentina,3,9,6,2,4,A1,229
A,Peru,3,4,3,3,0,A2,229
A,Chile,3,4,2,3,-1,A3,229
A,Canada,3,0,1,4,-3,A4,229
B,Ecuador,3,6,5,3,2,B1,229
B,Venezuela,3,4,4,5,-1,B2,229
B,Jamaica,3,4,3,4,-1,B3,229
B,Mexico,3,3,5,5,0,B4,229
C,Uruguay,3,7,8,4,4,C1,229
C,United States,3,6,7,3,4,C2,229
C,Panama,3,2,1,4,-3,C3,229
C,Bolivia,3,1,1,6,-5,C4,229
D,Brazil,3,9,8,2,6,D1,229
D,Colombia,3,6,4,3,1,D2,229
D,Costa Rica,3,1,0,3,-3,D3,229
D,Paraguay,3,1,0,4,-4,D4,229
A,Chile,3,9,9,3,6,A1,230
A,Peru,3,4,5,7,-2,A2,230
A,Argentina,3,3,6,5,1,A3,230
A,Canada,3,1,2,7,-5,A4,230
B,Mexico,3,7,6,4,2,B1,230
B,Ecuador,3,4,10,5,5,B2,230
B,Jamaica,3,3,2,8,-6,B3,230
B,Venezuela,3,2,3,4,-1,B4,230
C,Panama,3,6,4,2,2,C1,230
C,Uruguay,3,6,4,3,1,C2,230
C,United States,3,3,2,3,-1,C3,230
C,Bolivia,3,3,2,4,-2,C4,230
D,Brazil,3,7,6,2,4,D1,230
D,Costa Rica,3,6,4,5,-1,D2,230
D,Colombia,3,4,4,2,2,D3,230
D,Paraguay,3,0,1,6,-5,D4,230
A,Argentina,3,6,7,5,2,A1,231
A,Chile,3,6,6,5,1,A2,231
A,Peru,3,4,5,4,1,A3,231
A,Canada,3,1,3,7,-4,A4,231
B,Mexico,3,9,6,1,5,B1,231
B,Ecuador,3,4,2,1,1,B2,231
B,Venezuela,3,4,3,3,0,B3,231
B,Jamaica,3,0,0,6,-6,B4,231
C,United States,3,9,9,1,8,C1,231
C,Uruguay,3,6,7,4,3,C2,231
C,Bolivia,3,3,4,7,-3,C3,231
C,Panama,3,0,2,10,-8,C4,231
D,Brazil,3,9,6,1,5,D1,231
D,Colombia,3,4,6,7,-1,D2,231
D,Paraguay,3,3,3,4,-1,D3,231
D,Costa Rica,3,1,4,7,-3,D4,231
A,Chile,3,7,9,3,6,A1,232
A,Canada,3,5,5,3,2,A2,232
A,Argentina,3,3,3,5,-2,A3,232
A,Peru,3,1,2,8,-6,A4,232
B,Ecuador,3,6,3,3,0,B1,232
B,Jamaica,3,4,6,4,2,B2,232
B,Mexico,3,4,4,4,0,B3,232
B,Venezuela,3,3,5,7,-2,B4,232
C,Panama,3,7,7,3,4,C1,232
C,Uruguay,3,4,4,5,-1,C2,232
C,United States,3,3,3,3,0,C3,232
C,Bolivia,3,1,1,4,-3,C4,232
D,Colombia,3,7,5,3,2,D1,232
D,Brazil,3,6,5,1,4,D2,232
D,Paraguay,3,4,3,5,-2,D3,232
D,Costa Rica,3,0,1,5,-4,D4,232
A,Argentina,3,9,8,2,6,A1,233
A,Chile,3,4,3,3,0,A2,233
A,Canada,3,3,6,8,-2,A3,233
A,Peru,3,1,2,6,-4,A4,233
B,Ecuador,3,7,5,1,4,B1,233
B,Mexico,3,6,5,3,2,B2,233
B,Jamaica,3,3,4,7,-3,B3,233
B,Venezuela,3,1,1,4,-3,B4,233
C,Uruguay,3,9,5,2,3,C1,233
C,United States,3,4,4,3,1,C2,233
C,Panama,3,3,1,3,-2,C3,233
C,Bolivia,3,1,2,4,-2,C4,233
D,Colombia,3,9,6,2,4,D1,233
D,Brazil,3,6,4,2,2,D2,233
D,Paraguay,3,3,2,4,-2,D3,233
D,Costa Rica,3,0,0,4,-4,D4,233
A,Argentina,3,9,7,0,7,A1,234
A,Canada,3,4,2,5,-3,A2,234
A,Chile,3,2,1,3,-2,A3,234
A,Peru,3,1,0,2,-2,A4,234
B,Mexico,3,7,7,2,5,B1,234
B,Venezuela,3,6,5,4,1,B2,234
B,Jamaica,3,4,2,3,-1,B3,234
B,Ecuador,3,0,2,7,-5,B4,234
C,United States,3,7,5,2,3,C1,234
C,Uruguay,3,6,7,2,5,C2,234
C,Panama,3,2,2,5,-3,C3,234
C,Bolivia,3,1,1,6,-5,C4,234
D,Brazil,3,6,3,2,1,D1,234
D,Paraguay,3,6,3,2,1,D2,234
D,Colombia,3,3,4,2,2,D3,234
D,Costa Rica,3,3,1,5,-4,D4,234
A,Peru,3,5,3,2,1,A1,235
A,Argentina,3,4,6,5,1,A2,235
A,Chile,3,3,3,3,0,A3,235
A,Canada,3,2,3,5,-2,A4,235
B,Mexico,3,7,5,3,2,B1,235
B,Ecuador,3,5,8,6,2,B2,235
B,Jamaica,3,4,3,3,0,B3,235
B,Venezuela,3,0,3,7,-4,B4,235
C,Uruguay,3,9,5,2,3,C1,235
C,United States,3,6,4,2,2,C2,235
C,Bolivia,3,3,2,4,-2,C3,235
C,Panama,3,0,2,5,-3,C4,235
D,Paraguay,3,7,4,2,2,D1,235
D,Brazil,3,6,4,2,2,D2,235
D,Colombia,3,4,5,2,3,D3,235
D,Costa Rica,3,0,0,7,-7,D4,235
A,Argentina,3,9,5,0,5,A1,236
A,Canada,3,4,2,3,-1,A2,236
A,Chile,3,2,3,5,-2,A3,236
A,Peru,3,1,2,4,-2,A4,236
B,Jamaica,3,5,2,0,2,B1,236
B,Mexico,3,4,2,1,1,B2,236
B,Ecuador,3,4,2,3,-1,B3,236
B,Venezuela,3,2,1,3,-2,B4,236
C,Uruguay,3,7,3,1,2,C1,236
C,United States,3,4,2,1,1,C2,236
C,Bolivia,3,4,3,3,0,C3,236
C,Panama,3,1,1,4,-3,C4,236
D,Brazil,3,7,5,3,2,D1,236
D,Colombia,3,6,3,1,2,D2,236
D,Paraguay,3,4,4,4,0,D3,236
D,Costa Rica,3,0,3,7,-4,D4,236
A,Argentina,3,7,3,0,3,A1,237
A,Chile,3,5,2,1,1,A2,237
A,Peru,3,2,1,2,-1,A3,237
A,Canada,3,1,0,3,-3,A4,237
B,Mexico,3,5,4,1,3,B1,237
B,Venezuela,3,4,3,2,1,B2,237
B,Ecuador,3,4,3,4,-1,B3,237
B,Jamaica,3,3,3,6,-3,B4,237
C,United States,3,9,9,4,5,C1,237
C,Panama,3,4,3,4,-1,C2,237
C,Uruguay,3,3,6,6,0,C3,237
C,Bolivia,3,1,3,7,-4,C4,237
D,Brazil,3,7,6,2,4,D1,237
D,Colombia,3,4,3,1,2,D2,237
D,Paraguay,3,4,4,4,0,D3,237
D,Costa Rica,3,1,1,7,-6,D4,237
A,Chile,3,7,7,2,5,A1,238
A,Argentina,3,6,3,1,2,A2,238
A,Peru,3,2,2,3,-1,A3,238
A,Canada,3,1,2,8,-6,A4,238
B,Venezuela,3,7,5,3,2,B1,238
B,Mexico,3,6,5,2,3,B2,238
B,Ecuador,3,4,8,6,2,B3,238
B,Jamaica,3,0,2,9,-7,B4,238
C,Panama,3,6,4,4,0,C1,238
C,Bolivia,3,4,6,5,1,C2,238
C,Uruguay,3,4,5,4,1,C3,238
C,United States,3,3,3,5,-2,C4,238
D,Brazil,3,7,4,0,4,D1,238
D,Colombia,3,4,3,3,0,D2,238
D,Paraguay,3,2,2,3,-1,D3,238
D,Costa Rica,3,2,0,3,-3,D4,238
A,Argentina,3,9,7,0,7,A1,239
A,Canada,3,4,3,3,0,A2,239
A,Chile,3,2,1,5,-4,A3,239
A,Peru,3,1,3,6,-3,A4,239
B,Mexico,3,7,8,4,4,B1,239
B,Venezuela,3,6,9,4,5,B2,239
B,Ecuador,3,4,4,6,-2,B3,239
B,Jamaica,3,0,2,9,-7,B4,239
C,Uruguay,3,9,5,0,5,C1,239
C,Bolivia,3,6,5,4,1,C2,239
C,Panama,3,3,4,6,-2,C3,239
C,United States,3,0,1,5,-4,C4,239
D,Brazil,3,7,4,2,2,D1,239
D,Paraguay,3,4,4,4,0,D2,239
D,Colombia,3,3,4,4,0,D3,239
D,Costa Rica,3,2,1,3,-2,D4,239
A,Argentina,3,9,6,1,5,A1,240
A,Chile,3,4,5,3,2,A2,240
A,Peru,3,3,3,6,-3,A3,240
A,Canada,3,1,4,8,-4,A4,240
B,Mexico,3,7,6,2,4,B1,240
B,Ecuador,3,5,2,1,1,B2,240
B,Venezuela,3,3,2,5,-3,B3,240
B,Jamaica,3,1,2,4,-2,B4,240
C,Uruguay,3,9,6,1,5,C1,240
C,United States,3,4,4,2,2,C2,240
C,Panama,3,4,1,3,-2,C3,240
C,Bolivia,3,0,0,5,-5,C4,240
D,Brazil,3,7,5,2,3,D1,240
D,Paraguay,3,4,5,5,0,D2,240
D,Colombia,3,2,1,2,-1,D3,240
D,Costa Rica,3,2,2,4,-2,D4,240
A,Argentina,3,7,7,3,4,A1,241
A,Peru,3,5,3,2,1,A2,241
A,Canada,3,4,3,4,-1,A3,241
A,Chile,3,0,1,5,-4,A4,241
B,Mexico,3,5,3,2,1,B1,241
B,Jamaica,3,4,4,3,1,B2,241
B,Venezuela,3,4,3,4,-1,B3,241
B,Ecuador,3,3,4,5,-1,B4,241
C,Uruguay,3,7,6,1,5,C1,241
C,United States,3,5,5,3,2,C2,241
C,Bolivia,3,4,5,4,1,C3,241
C,Panama,3,0,2,10,-8,C4,241
D,Brazil,3,7,5,0,5,D1,241
D,Paraguay,3,6,3,1,2,D2,241
D,Colombia,3,4,2,1,1,D3,241
D,Costa Rica,3,0,0,8,-8,D4,241
A,Argentina,3,7,10,2,8,A1,242
A,Peru,3,5,4,2,2,A2,242
A,Chile,3,3,4,6,-2,A3,242
A,Canada,3,1,3,11,-8,A4,242
B,Mexico,3,7,5,2,3,B1,242
B,Jamaica,3,4,2,2,0,B2,242
B,Ecuador,3,3,2,2,0,B3,242
B,Venezuela,3,1,3,6,-3,B4,242
C,United States,3,7,7,3,4,C1,242
C,Panama,3,6,4,4,0,C2,242
C,Uruguay,3,2,4,5,-1,C3,242
C,Bolivia,3,1,2,5,-3,C4,242
D,Brazil,3,6,7,3,4,D1,242
D,Costa Rica,3,4,5,5,0,D2,242
D,Paraguay,3,4,4,7,-3,D3,242
D,Colombia,3,3,4,5,-1,D4,242
A,Argentina,3,9,4,1,3,A1,243
A,Canada,3,3,2,3,-1,A2,243
A,Chile,3,3,2,3,-1,A3,243
A,Peru,3,3,2,3,-1,A4,243
B,Ecuador,3,9,9,1,8,B1,243
B,Mexico,3,6,6,3,3,B2,243
B,Jamaica,3,3,1,6,-5,B3,243
B,Venezuela,3,0,1,7,-6,B4,243
C,Uruguay,3,5,6,4,2,C1,243
C,Panama,3,5,3,2,1,C2,243
C,United States,3,4,2,2,0,C3,243
C,Bolivia,3,1,3,6,-3,C4,243
D,Colombia,3,7,5,3,2,D1,243
D,Brazil,3,6,6,4,2,D2,243
D,Paraguay,3,2,0,1,-1,D3,243
D,Costa Rica,3,1,2,5,-3,D4,243
A,Argentina,3,6,6,3,3,A1,244
A,Peru,3,6,6,4,2,A2,244
A,Chile,3,6,5,3,2,A3,244
A,Canada,3,0,2,9,-7,A4,244
B,Mexico,3,9,5,1,4,B1,244
B,Ecuador,3,4,6,4,2,B2,244
B,Venezuela,3,4,3,2,1,B3,244
B,Jamaica,3,0,1,8,-7,B4,244
C,United States,3,7,5,3,2,C1,244
C,Uruguay,3,5,5,3,2,C2,244
C,Bolivia,3,3,2,3,-1,C3,244
C,Panama,3,1,2,5,-3,C4,244
D,Brazil,3,7,6,2,4,D1,244
D,Colombia,3,5,6,1,5,D2,244
D,Costa Rica,3,4,2,4,-2,D3,244
D,Paraguay,3,0,0,7,-7,D4,244
A,Argentina,3,6,7,4,3,A1,245
A,Chile,3,5,4,1,3,A2,245
A,Canada,3,4,3,6,-3,A3,245
A,Peru,3,1,2,5,-3,A4,245
B,Mexico,3,7,10,4,6,B1,245
B,Ecuador,3,4,3,3,0,B2,245
B,Jamaica,3,4,3,6,-3,B3,245
B,Venezuela,3,1,1,4,-3,B4,245
C,United States,3,9,8,0,8,C1,245
C,Bolivia,3,6,3,4,-1,C2,245
C,Uruguay,3,3,3,4,-1,C3,245
C,Panama,3,0,0,6,-6,C4,245
D,Brazil,3,7,5,1,4,D1,245
D,Paraguay,3,6,3,4,-1,D2,245
D,Costa Rica,3,3,3,3,0,D3,245
D,Colombia,3,1,3,6,-3,D4,245
A,Chile,3,7,6,3,3,A1,246
A,Argentina,3,5,7,3,4,A2,246
A,Peru,3,4,3,4,-1,A3,246
A,Canada,3,0,2,8,-6,A4,246
B,Venezuela,3,7,3,1,2,B1,246
B,Ecuador,3,4,5,2,3,B2,246
B,Mexico,3,3,3,3,0,B3,246
B,Jamaica,3,1,3,8,-5,B4,246
C,Uruguay,3,7,7,2,5,C1,246
C,United States,3,7,6,3,3,C2,246
C,Panama,3,3,7,6,1,C3,246
C,Bolivia,3,0,0,9,-9,C4,246
D,Costa Rica,3,6,2,3,-1,D1,246
D,Brazil,3,5,4,1,3,D2,246
D,Colombia,3,4,3,2,1,D3,246
D,Paraguay,3,1,0,3,-3,D4,246
A,Argentina,3,9,6,0,6,A1,247
A,Peru,3,6,2,2,0,A2,247
A,Canada,3,3,1,4,-3,A3,247
A,Chile,3,0,0,3,-3,A4,247
B,Mexico,3,7,7,5,2,B1,247
B,Venezuela,3,4,5,6,-1,B2,247
B,Ecuador,3,3,4,3,1,B3,247
B,Jamaica,3,3,4,6,-2,B4,247
C,Uruguay,3,7,4,0,4,C1,247
C,United States,3,5,2,1,1,C2,247
C,Panama,3,3,4,4,0,C3,247
C,Bolivia,3,1,3,8,-5,C4,247
D,Brazil,3,9,7,1,6,D1,247
D,Costa Rica,3,4,5,6,-1,D2,247
D,Colombia,3,2,4,5,-1,D3,247
D,Paraguay,3,1,2,6,-4,D4,247
A,Argentina,3,5,3,1,2,A1,248
A,Chile,3,5,2,1,1,A2,248
A,Canada,3,4,2,2,0,A3,248
A,Peru,3,1,2,5,-3,A4,248
B,Mexico,3,7,3,0,3,B1,248
B,Jamaica,3,4,2,1,1,B2,248
B,Ecuador,3,4,2,3,-1,B3,248
B,Venezuela,3,1,1,4,-3,B4,248
C,United States,3,9,11,4,7,C1,248
C,Uruguay,3,4,4,6,-2,C2,248
C,Bolivia,3,3,6,8,-2,C3,248
C,Panama,3,1,0,3,-3,C4,248
D,Colombia,3,7,6,4,2,D1,248
D,Paraguay,3,5,2,1,1,D2,248
D,Brazil,3,4,7,3,4,D3,248
D,Costa Rica,3,0,1,8,-7,D4,248
A,Argentina,3,9,9,2,7,A1,249
A,Canada,3,4,2,2,0,A2,249
A,Chile,3,2,2,5,-3,A3,249
A,Peru,3,1,1,5,-4,A4,249
B,Mexico,3,5,2,1,1,B1,249
B,Ecuador,3,4,2,2,0,B2,249
B,Venezuela,3,3,1,1,0,B3,249
B,Jamaica,3,2,1,2,-1,B4,249
C,United States,3,7,6,1,5,C1,249
C,Uruguay,3,3,1,1,0,C2,249
C,Panama,3,2,1,3,-2,C3,249
C,Bolivia,3,2,3,6,-3,C4,249
D,Brazil,3,6,7,2,5,D1,249
D,Paraguay,3,6,4,4,0,D2,249
D,Colombia,3,4,2,1,1,D3,249
D,Costa Rica,3,1,1,7,-6,D4,249
A,Argentina,3,9,6,1,5,A1,250
A,Canada,3,4,2,2,0,A2,250
A,Chile,3,3,4,4,0,A3,250
A,Peru,3,1,0,5,-5,A4,250
B,Mexico,3,9,7,0,7,B1,250
B,Ecuador,3,6,4,3,1,B2,250
B,Venezuela,3,3,1,4,-3,B3,250
B,Jamaica,3,0,1,6,-5,B4,250
C,United States,3,7,4,2,2,C1,250
C,Uruguay,3,5,2,0,2,C2,250
C,Panama,3,3,2,4,-2,C3,250
C,Bolivia,3,1,1,3,-2,C4,250
D,Brazil,3,9,8,1,7,D1,250
D,Colombia,3,6,5,4,1,D2,250
D,Costa Rica,3,3,2,7,-5,D3,250
D,Paraguay,3,0,2,5,-3,D4,250
A,Argentina,3,9,6,0,6,A1,251
A,Peru,3,6,2,2,0,A2,251
A,Chile,3,3,2,2,0,A3,251
A,Canada,3,0,0,6,-6,A4,251
B,Mexico,3,7,7,3,4,B1,251
B,Venezuela,3,7,6,2,4,B2,251
B,Ecuador,3,1,2,5,-3,B3,251
B,Jamaica,3,1,1,6,-5,B4,251
C,Uruguay,3,7,5,2,3,C1,251
C,United States,3,5,4,3,1,C2,251
C,Bolivia,3,4,6,6,0,C3,251
C,Panama,3,0,1,5,-4,C4,251
D,Colombia,3,7,4,0,4,D1,251
D,Paraguay,3,6,3,3,0,D2,251
D,Brazil,3,3,3,4,-1,D3,251
D,Costa Rica,3,1,0,3,-3,D4,251
A,Argentina,3,7,4,2,2,A1,252
A,Canada,3,4,4,4,0,A2,252
A,Chile,3,3,5,5,0,A3,252
A,Peru,3,3,3,5,-2,A4,252
B,Ecuador,3,7,6,2,4,B1,252
B,Venezuela,3,4,4,4,0,B2,252
B,Mexico,3,3,2,2,0,B3,252
B,Jamaica,3,1,1,5,-4,B4,252
C,Uruguay,3,9,9,2,7,C1,252
C,United States,3,6,5,4,1,C2,252
C,Panama,3,3,4,7,-3,C3,252
C,Bolivia,3,0,1,6,-5,C4,252
D,Brazil,3,9,9,2,7,D1,252
D,Colombia,3,3,4,3,1,D2,252
D,Paraguay,3,3,5,6,-1,D3,252
D,Costa Rica,3,3,1,8,-7,D4,252
A,Chile,3,7,4,1,3,A1,253
A,Peru,3,3,2,2,0,A2,253
A,Argentina,3,2,4,5,-1,A3,253
A,Canada,3,2,3,5,-2,A4,253
B,Mexico,3,7,4,2,2,B1,253
B,Jamaica,3,4,3,3,0,B2,253
B,Ecuador,3,3,2,2,0,B3,253
B,Venezuela,3,1,2,4,-2,B4,253
C,United States,3,7,3,1,2,C1,253
C,Uruguay,3,5,3,1,2,C2,253
C,Panama,3,2,2,3,-1,C3,253
C,Bolivia,3,1,0,3,-3,C4,253
D,Brazil,3,6,6,2,4,D1,253
D,Paraguay,3,4,5,4,1,D2,253
D,Colombia,3,4,2,2,0,D3,253
D,Costa Rica,3,3,2,7,-5,D4,253
A,Chile,3,9,8,4,4,A1,254
A,Argentina,3,4,8,6,2,A2,254
A,Canada,3,3,7,10,-3,A3,254
A,Peru,3,1,4,7,-3,A4,254
B,Venezuela,3,9,5,0,5,B1,254
B,Ecuador,3,4,6,5,1,B2,254
B,Mexico,3,4,2,2,0,B3,254
B,Jamaica,3,0,1,7,-6,B4,254
C,United States,3,6,8,1,7,C1,254
C,Uruguay,3,6,6,5,1,C2,254
C,Bolivia,3,6,4,3,1,C3,254
C,Panama,3,0,1,10,-9,C4,254
D,Brazil,3,9,6,1,5,D1,254
D,Colombia,3,4,3,3,0,D2,254
D,Costa Rica,3,4,2,2,0,D3,254
D,Paraguay,3,0,0,5,-5,D4,254
A,Peru,3,6,7,3,4,A1,255
A,Canada,3,4,4,4,0,A2,255
A,Chile,3,4,5,8,-3,A3,255
A,Argentina,3,3,4,5,-1,A4,255
B,Mexico,3,9,11,2,9,B1,255
B,Venezuela,3,6,3,4,-1,B2,255
B,Jamaica,3,1,1,4,-3,B3,255
B,Ecuador,3,1,2,7,-5,B4,255
C,United States,3,7,5,3,2,C1,255
C,Uruguay,3,6,5,2,3,C2,255
C,Bolivia,3,4,4,5,-1,C3,255
C,Panama,3,0,2,6,-4,C4,255
D,Brazil,3,5,6,2,4,D1,255
D,Colombia,3,4,3,3,0,D2,255
D,Paraguay,3,4,2,4,-2,D3,255
D,Costa Rica,3,3,4,6,-2,D4,255
A,Chile,3,9,4,1,3,A1,256
A,Argentina,3,6,6,1,5,A2,256
A,Peru,3,3,3,7,-4,A3,256
A,Canada,3,0,2,6,-4,A4,256
B,Mexico,3,6,4,3,1,B1,256
B,Jamaica,3,6,4,4,0,B2,256
B,Ecuador,3,4,6,5,1,B3,256
B,Venezuela,3,1,2,4,-2,B4,256
C,United States,3,5,5,2,3,C1,256
C,Panama,3,5,7,5,2,C2,256
C,Bolivia,3,3,3,6,-3,C3,256
C,Uruguay,3,2,2,4,-2,C4,256
D,Brazil,3,7,6,0,6,D1,256
D,Colombia,3,5,3,0,3,D2,256
D,Costa Rica,3,3,2,7,-5,D3,256
D,Paraguay,3,1,0,4,-4,D4,256
A,Argentina,3,7,7,2,5,A1,257
A,Peru,3,4,2,5,-3,A2,257
A,Canada,3,3,2,3,-1,A3,257
A,Chile,3,2,2,3,-1,A4,257
B,Mexico,3,7,5,3,2,B1,257
B,Ecuador,3,5,5,3,2,B2,257
B,Venezuela,3,4,4,3,1,B3,257
B,Jamaica,3,0,0,5,-5,B4,257
C,United States,3,9,9,3,6,C1,257
C,Uruguay,3,6,5,4,1,C2,257
C,Panama,3,3,3,6,-3,C3,257
C,Bolivia,3,0,3,7,-4,C4,257
D,Brazil,3,9,9,0,9,D1,257
D,Colombia,3,4,3,3,0,D2,257
D,Paraguay,3,4,1,2,-1,D3,257
D,Costa Rica,3,0,0,8,-8,D4,257
A,Argentina,3,9,7,0,7,A1,258
A,Chile,3,6,8,4,4,A2,258
A,Peru,3,3,2,7,-5,A3,258
A,Canada,3,0,1,7,-6,A4,258
B,Mexico,3,9,8,0,8,B1,258
B,Ecuador,3,3,4,5,-1,B2,258
B,Jamaica,3,3,2,3,-1,B3,258
B,Venezuela,3,3,2,8,-6,B4,258
C,Uruguay,3,7,12,3,9,C1,258
C,United States,3,5,8,5,3,C2,258
C,Panama,3,2,4,7,-3,C3,258
C,Bolivia,3,1,0,9,-9,C4,258
D,Brazil,3,7,5,1,4,D1,258
D,Colombia,3,6,5,1,4,D2,258
D,Costa Rica,3,4,3,3,0,D3,258
D,Paraguay,3,0,1,9,-8,D4,258
A,Chile,3,7,5,2,3,A1,259
A,Peru,3,4,2,1,1,A2,259
A,Argentina,3,4,3,3,0,A3,259
A,Canada,3,1,1,5,-4,A4,259
B,Ecuador,3,7,3,1,2,B1,259
B,Mexico,3,6,6,3,3,B2,259
B,Jamaica,3,2,1,2,-1,B3,259
B,Venezuela,3,1,2,6,-4,B4,259
C,Panama,3,5,6,5,1,C1,259
C,Uruguay,3,4,7,4,3,C2,259
C,United States,3,3,3,3,0,C3,259
C,Bolivia,3,2,3,7,-4,C4,259
D,Brazil,3,7,4,2,2,D1,259
D,Colombia,3,6,9,3,6,D2,259
D,Costa Rica,3,3,4,5,-1,D3,259
D,Paraguay,3,1,3,10,-7,D4,259
A,Argentina,3,7,10,4,6,A1,260
A,Canada,3,6,5,7,-2,A2,260
A,Peru,3,2,4,5,-1,A3,260
A,Chile,3,1,4,7,-3,A4,260
B,Ecuador,3,5,4,2,2,B1,260
B,Mexico,3,3,3,3,0,B2,260
B,Venezuela,3,3,3,3,0,B3,260
B,Jamaica,3,2,4,6,-2,B4,260
C,United States,3,6,6,4,2,C1,260
C,Uruguay,3,4,4,3,1,C2,260
C,Bolivia,3,4,3,4,-1,C3,260
C,Panama,3,3,4,6,-2,C4,260
D,Brazil,3,7,9,4,5,D1,260
D,Paraguay,3,4,4,6,-2,D2,260
D,Colombia,3,2,3,4,-1,D3,260
D,Costa Rica,3,2,2,4,-2,D4,260
A,Canada,3,5,5,2,3,A1,261
A,Argentina,3,5,5,3,2,A2,261
A,Chile,3,3,2,6,-4,A3,261
A,Peru,3,2,2,3,-1,A4,261
B,Ecuador,3,7,4,1,3,B1,261
B,Jamaica,3,6,5,3,2,B2,261
B,Venezuela,3,2,2,3,-1,B3,261
B,Mexico,3,1,1,5,-4,B4,261
C,Uruguay,3,9,9,1,8,C1,261
C,United States,3,6,9,3,6,C2,261
C,Panama,3,1,0,5,-5,C3,261
C,Bolivia,3,1,1,10,-9,C4,261
D,Brazil,3,7,5,0,5,D1,261
D,Colombia,3,4,2,3,-1,D2,261
D,Costa Rica,3,2,2,3,-1,D3,261
D,Paraguay,3,2,1,4,-3,D4,261
A,Argentina,3,7,5,3,2,A1,262
A,Peru,3,6,6,3,3,A2,262
A,Chile,3,4,4,6,-2,A3,262
A,Canada,3,0,0,3,-3,A4,262
B,Ecuador,3,9,5,1,4,B1,262
B,Mexico,3,4,2,1,1,B2,262
B,Jamaica,3,2,1,2,-1,B3,262
B,Venezuela,3,1,0,4,-4,B4,262
C,United States,3,9,10,4,6,C1,262
C,Uruguay,3,4,7,6,1,C2,262
C,Bolivia,3,3,4,7,-3,C3,262
C,Panama,3,1,3,7,-4,C4,262
D,Brazil,3,9,10,0,10,D1,262
D,Colombia,3,4,3,2,1,D2,262
D,Paraguay,3,2,3,7,-4,D3,262
D,Costa Rica,3,1,2,9,-7,D4,262
A,Argentina,3,7,4,1,3,A1,263
A,Chile,3,6,4,3,1,A2,263
A,Peru,3,2,1,2,-1,A3,263
A,Canada,3,1,2,5,-3,A4,263
B,Venezuela,3,7,6,1,5,B1,263
B,Ecuador,3,4,3,5,-2,B2,263
B,Jamaica,3,3,5,7,-2,B3,263
B,Mexico,3,2,1,2,-1,B4,263
C,United States,3,9,5,2,3,C1,263
C,Uruguay,3,6,6,4,2,C2,263
C,Bolivia,3,3,3,5,-2,C3,263
C,Panama,3,0,1,4,-3,C4,263
D,Colombia,3,7,7,2,5,D1,263
D,Brazil,3,6,4,2,2,D2,263
D,Costa Rica,3,4,3,3,0,D3,263
D,Paraguay,3,0,1,8,-7,D4,263
A,Argentina,3,5,4,2,2,A1,264
A,Canada,3,5,4,3,1,A2,264
A,Peru,3,3,2,2,0,A3,264
A,Chile,3,1,1,4,-3,A4,264
B,Ecuador,3,5,5,4,1,B1,264
B,Mexico,3,4,8,6,2,B2,264
B,Venezuela,3,4,4,5,-1,B3,264
B,Jamaica,3,3,4,6,-2,B4,264
C,Uruguay,3,9,8,3,5,C1,264
C,United States,3,6,6,4,2,C2,264
C,Panama,3,3,5,5,0,C3,264
C,Bolivia,3,0,2,9,-7,C4,264
D,Colombia,3,9,5,0,5,D1,264
D,Paraguay,3,2,2,3,-1,D2,264
D,Brazil,3,2,2,4,-2,D3,264
D,Costa Rica,3,2,0,2,-2,D4,264
A,Argentina,3,9,8,0,8,A1,265
A,Chile,3,4,4,4,0,A2,265
A,Peru,3,3,1,5,-4,A3,265
A,Canada,3,1,1,5,-4,A4,265
B,Mexico,3,7,9,4,5,B1,265
B,Ecuador,3,7,8,4,4,B2,265
B,Jamaica,3,3,3,5,-2,B3,265
B,Venezuela,3,0,1,8,-7,B4,265
C,Uruguay,3,9,7,1,6,C1,265
C,Panama,3,4,3,3,0,C2,265
C,United States,3,4,4,6,-2,C3,265
C,Bolivia,3,0,1,5,-4,C4,265
D,Colombia,3,7,6,1,5,D1,265
D,Brazil,3,7,5,1,4,D2,265
D,Paraguay,3,3,1,4,-3,D3,265
D,Costa Rica,3,0,0,6,-6,D4,265
A,Peru,3,7,3,1,2,A1,266
A,Argentina,3,4,4,1,3,A2,266
A,Canada,3,4,3,5,-2,A3,266
A,Chile,3,1,0,3,-3,A4,266
B,Mexico,3,7,6,3,3,B1,266
B,Ecuador,3,4,8,7,1,B2,266
B,Venezuela,3,4,4,4,0,B3,266
B,Jamaica,3,1,4,8,-4,B4,266
C,United States,3,9,4,1,3,C1,266
C,Uruguay,3,6,5,3,2,C2,266
C,Bolivia,3,1,3,5,-2,C3,266
C,Panama,3,1,2,5,-3,C4,266
D,Brazil,3,9,4,0,4,D1,266
D,Colombia,3,6,5,2,3,D2,266
D,Costa Rica,3,3,3,7,-4,D3,266
D,Paraguay,3,0,1,4,-3,D4,266
A,Argentina,3,7,6,2,4,A1,267
A,Canada,3,4,5,6,-1,A2,267
A,Chile,3,3,5,6,-1,A3,267
A,Peru,3,3,4,6,-2,A4,267
B,Mexico,3,9,6,1,5,B1,267
B,Venezuela,3,4,4,3,1,B2,267
B,Ecuador,3,2,1,2,-1,B3,267
B,Jamaica,3,1,0,5,-5,B4,267
C,Uruguay,3,7,8,3,5,C1,267
C,United States,3,7,9,5,4,C2,267
C,Panama,3,3,5,5,0,C3,267
C,Bolivia,3,0,1,10,-9,C4,267
D,Colombia,3,7,3,0,3,D1,267
D,Brazil,3,6,6,3,3,D2,267
D,Paraguay,3,4,2,5,-3,D3,267
D,Costa Rica,3,0,2,5,-3,D4,267
A,Argentina,3,7,7,4,3,A1,268
A,Chile,3,5,5,4,1,A2,268
A,Canada,3,4,2,2,0,A3,268
A,Peru,3,0,3,7,-4,A4,268
B,Mexico,3,9,12,3,9,B1,268
B,Ecuador,3,6,5,5,0,B2,268
B,Venezuela,3,1,3,6,-3,B3,268
B,Jamaica,3,1,2,8,-6,B4,268
C,United States,3,7,7,1,6,C1,268
C,Uruguay,3,5,3,1,2,C2,268
C,Panama,3,2,2,7,-5,C3,268
C,Bolivia,3,1,2,5,-3,C4,268
D,Brazil,3,7,6,3,3,D1,268
D,Colombia,3,6,4,1,3,D2,268
D,Paraguay,3,2,3,5,-2,D3,268
D,Costa Rica,3,1,2,6,-4,D4,268
A,Canada,3,7,3,1,2,A1,269
A,Argentina,3,4,3,3,0,A2,269
A,Chile,3,4,2,2,0,A3,269
A,Peru,3,1,2,4,-2,A4,269
B,Venezuela,3,7,6,2,4,B1,269
B,Ecuador,3,6,3,3,0,B2,269
B,Jamaica,3,3,4,6,-2,B3,269
B,Mexico,3,1,4,6,-2,B4,269
C,Uruguay,3,9,11,0,11,C1,269
C,United States,3,6,5,3,2,C2,269
C,Bolivia,3,3,2,7,-5,C3,269
C,Panama,3,0,2,10,-8,C4,269
D,Brazil,3,7,4,1,3,D1,269
D,Colombia,3,5,5,1,4,D2,269
D,Paraguay,3,4,1,1,0,D3,269
D,Costa Rica,3,0,2,9,-7,D4,269
A,Argentina,3,9,5,0,5,A1,270
A,Peru,3,4,2,1,1,A2,270
A,Canada,3,3,1,5,-4,A3,270
A,Chile,3,1,0,2,-2,A4,270
B,Mexico,3,7,6,3,3,B1,270
B,Venezuela,3,4,3,1,2,B2,270
B,Jamaica,3,3,4,8,-4,B3,270
B,Ecuador,3,2,4,5,-1,B4,270
C,Bolivia,3,5,4,0,4,C1,270
C,Uruguay,3,5,4,2,2,C2,270
C,United States,3,3,2,2,0,C3,270
C,Panama,3,1,2,8,-6,C4,270
D,Brazil,3,9,5,0,5,D1,270
D,Paraguay,3,4,6,3,3,D2,270
D,Colombia,3,2,2,3,-1,D3,270
D,Costa Rica,3,1,2,9,-7,D4,270
A,Argentina,3,7,8,0,8,A1,271
A,Chile,3,5,5,1,4,A2,271
A,Canada,3,2,2,4,-2,A3,271
A,Peru,3,1,1,11,-10,A4,271
B,Ecuador,3,6,3,2,1,B1,271
B,Jamaica,3,6,3,2,1,B2,271
B,Venezuela,3,3,3,4,-1,B3,271
B,Mexico,3,3,1,2,-1,B4,271
C,United States,3,7,4,0,4,C1,271
C,Panama,3,5,2,1,1,C2,271
C,Uruguay,3,3,3,3,0,C3,271
C,Bolivia,3,1,1,6,-5,C4,271
D,Brazil,3,9,8,1,7,D1,271
D,Colombia,3,4,6,5,1,D2,271
D,Costa Rica,3,2,3,5,-2,D3,271
D,Paraguay,3,1,4,10,-6,D4,271
A,Argentina,3,9,7,2,5,A1,272
A,Chile,3,4,2,2,0,A2,272
A,Peru,3,2,1,4,-3,A3,272
A,Canada,3,1,4,6,-2,A4,272
B,Mexico,3,4,3,1,2,B1,272
B,Venezuela,3,4,2,1,1,B2,272
B,Ecuador,3,4,1,2,-1,B3,272
B,Jamaica,3,4,1,3,-2,B4,272
C,Uruguay,3,6,8,3,5,C1,272
C,Bolivia,3,6,2,2,0,C2,272
C,United States,3,4,4,7,-3,C3,272
C,Panama,3,1,2,4,-2,C4,272
D,Brazil,3,9,4,0,4,D1,272
D,Colombia,3,4,3,3,0,D2,272
D,Costa Rica,3,2,1,2,-1,D3,272
D,Paraguay,3,1,1,4,-3,D4,272
A,Chile,3,7,4,1,3,A1,273
A,Argentina,3,5,4,3,1,A2,273
A,Canada,3,4,4,5,-1,A3,273
A,Peru,3,0,1,4,-3,A4,273
B,Mexico,3,6,4,1,3,B1,273
B,Venezuela,3,4,5,5,0,B2,273
B,Ecuador,3,4,4,4,0,B3,273
B,Jamaica,3,3,2,5,-3,B4,273
C,Bolivia,3,7,9,7,2,C1,273
C,United States,3,5,7,6,1,C2,273
C,Panama,3,4,4,4,0,C3,273
C,Uruguay,3,0,2,5,-3,C4,273
D,Brazil,3,9,11,0,11,D1,273
D,Colombia,3,6,5,2,3,D2,273
D,Costa Rica,3,3,1,8,-7,D3,273
D,Paraguay,3,0,0,7,-7,D4,273
A,Argentina,3,9,9,1,8,A1,274
A,Peru,3,6,3,4,-1,A2,274
A,Canada,3,1,2,5,-3,A3,274
A,Chile,3,1,1,5,-4,A4,274
B,Venezuela,3,5,5,2,3,B1,274
B,Mexico,3,5,5,4,1,B2,274
B,Ecuador,3,3,4,6,-2,B3,274
B,Jamaica,3,2,4,6,-2,B4,274
C,Uruguay,3,9,6,0,6,C1,274
C,United States,3,6,5,5,0,C2,274
C,Bolivia,3,3,4,6,-2,C3,274
C,Panama,3,0,2,6,-4,C4,274
D,Brazil,3,9,7,1,6,D1,274
D,Colombia,3,6,4,4,0,D2,274
D,Costa Rica,3,1,2,5,-3,D3,274
D,Paraguay,3,1,1,4,-3,D4,274
A,Peru,3,7,5,3,2,A1,275
A,Argentina,3,5,6,5,1,A2,275
A,Canada,3,2,6,7,-1,A3,275
A,Chile,3,1,2,4,-2,A4,275
B,Mexico,3,6,6,3,3,B1,275
B,Ecuador,3,6,5,2,3,B2,275
B,Venezuela,3,3,4,6,-2,B3,275
B,Jamaica,3,3,3,7,-4,B4,275
C,Panama,3,7,5,2,3,C1,275
C,United States,3,6,5,3,2,C2,275
C,Uruguay,3,3,4,3,1,C3,275
C,Bolivia,3,1,3,9,-6,C4,275
D,Colombia,3,9,5,0,5,D1,275
D,Costa Rica,3,4,2,3,-1,D2,275
D,Brazil,3,2,1,2,-1,D3,275
D,Paraguay,3,1,2,5,-3,D4,275
A,Peru,3,5,6,2,4,A1,276
A,Canada,3,4,4,7,-3,A2,276
A,Argentina,3,3,1,1,0,A3,276
A,Chile,3,2,4,5,-1,A4,276
B,Ecuador,3,6,3,2,1,B1,276
B,Jamaica,3,4,4,3,1,B2,276
B,Mexico,3,4,3,3,0,B3,276
B,Venezuela,3,3,4,6,-2,B4,276
C,Bolivia,3,5,3,2,1,C1,276
C,Uruguay,3,4,3,1,2,C2,276
C,United States,3,4,3,3,0,C3,276
C,Panama,3,2,0,3,-3,C4,276
D,Colombia,3,9,6,0,6,D1,276
D,Brazil,3,6,5,3,2,D2,276
D,Costa Rica,3,1,2,4,-2,D3,276
D,Paraguay,3,1,1,7,-6,D4,276
A,Argentina,3,7,4,1,3,A1,277
A,Canada,3,6,5,3,2,A2,277
A,Peru,3,4,2,4,-2,A3,277
A,Chile,3,0,1,4,-3,A4,277
B,Venezuela,3,7,4,1,3,B1,277
B,Mexico,3,5,5,2,3,B2,277
B,Jamaica,3,3,3,7,-4,B3,277
B,Ecuador,3,1,3,5,-2,B4,277
C,United States,3,9,7,2,5,C1,277
C,Uruguay,3,4,5,5,0,C2,277
C,Bolivia,3,3,4,7,-3,C3,277
C,Panama,3,1,3,5,-2,C4,277
D,Brazil,3,9,8,3,5,D1,277
D,Colombia,3,6,4,3,1,D2,277
D,Paraguay,3,1,2,4,-2,D3,277
D,Costa Rica,3,1,5,9,-4,D4,277
A,Argentina,3,7,5,3,2,A1,278
A,Canada,3,4,2,2,0,A2,278
A,Peru,3,3,2,2,0,A3,278
A,Chile,3,1,0,2,-2,A4,278
B,Venezuela,3,6,4,2,2,B1,278
B,Ecuador,3,5,5,3,2,B2,278
B,Mexico,3,4,4,2,2,B3,278
B,Jamaica,3,1,2,8,-6,B4,278
C,United States,3,7,2,0,2,C1,278
C,Bolivia,3,5,4,2,2,C2,278
C,Uruguay,3,4,5,3,2,C3,278
C,Panama,3,0,2,8,-6,C4,278
D,Colombia,3,7,3,0,3,D1,278
D,Brazil,3,6,7,3,4,D2,278
D,Paraguay,3,4,1,1,0,D3,278
D,Costa Rica,3,0,2,9,-7,D4,278
A,Argentina,3,7,6,0,6,A1,279
A,Peru,3,4,4,4,0,A2,279
A,Chile,3,3,3,6,-3,A3,279
A,Canada,3,3,2,5,-3,A4,279
B,Ecuador,3,7,3,0,3,B1,279
B,Venezuela,3,6,5,2,3,B2,279
B,Mexico,3,4,4,6,-2,B3,279
B,Jamaica,3,0,4,8,-4,B4,279
C,United States,3,7,9,2,7,C1,279
C,Uruguay,3,5,5,3,2,C2,279
C,Bolivia,3,3,5,6,-1,C3,279
C,Panama,3,1,2,10,-8,C4,279
D,Brazil,3,9,10,1,9,D1,279
D,Colombia,3,4,3,2,1,D2,279
D,Paraguay,3,4,3,4,-1,D3,279
D,Costa Rica,3,0,1,10,-9,D4,279
A,Argentina,3,7,7,1,6,A1,280
A,Peru,3,5,8,3,5,A2,280
A,Chile,3,4,5,3,2,A3,280
A,Canada,3,0,2,15,-13,A4,280
B,Mexico,3,7,3,0,3,B1,280
B,Venezuela,3,4,3,4,-1,B2,280
B,Ecuador,3,3,3,2,1,B3,280
B,Jamaica,3,3,2,5,-3,B4,280
C,United States,3,7,8,3,5,C1,280
C,Bolivia,3,5,6,5,1,C2,280
C,Panama,3,3,2,6,-4,C3,280
C,Uruguay,3,1,3,5,-2,C4,280
D,Brazil,3,9,8,0,8,D1,280
D,Colombia,3,6,4,2,2,D2,280
D,Paraguay,3,1,0,3,-3,D3,280
D,Costa Rica,3,1,0,7,-7,D4,280
A,Argentina,3,9,9,2,7,A1,281
A,Chile,3,3,4,4,0,A2,281
A,Peru,3,3,3,4,-1,A3,281
A,Canada,3,3,3,9,-6,A4,281
B,Mexico,3,6,9,4,5,B1,281
B,Venezuela,3,6,4,3,1,B2,281
B,Jamaica,3,6,5,5,0,B3,281
B,Ecuador,3,0,3,9,-6,B4,281
C,Uruguay,3,7,5,3,2,C1,281
C,Bolivia,3,4,4,4,0,C2,281
C,United States,3,4,3,3,0,C3,281
C,Panama,3,1,2,4,-2,C4,281
D,Brazil,3,7,5,0,5,D1,281
D,Colombia,3,5,2,0,2,D2,281
D,Paraguay,3,4,2,3,-1,D3,281
D,Costa Rica,3,0,1,7,-6,D4,281
A,Argentina,3,7,9,2,7,A1,282
A,Peru,3,3,4,4,0,A2,282
A,Chile,3,2,4,7,-3,A3,282
A,Canada,3,2,2,6,-4,A4,282
B,Ecuador,3,7,6,1,5,B1,282
B,Mexico,3,5,5,2,3,B2,282
B,Venezuela,3,4,4,3,1,B3,282
B,Jamaica,3,0,1,10,-9,B4,282
C,Uruguay,3,7,9,2,7,C1,282
C,United States,3,6,8,4,4,C2,282
C,Panama,3,4,3,3,0,C3,282
C,Bolivia,3,0,0,11,-11,C4,282
D,Brazil,3,9,6,1,5,D1,282
D,Paraguay,3,4,3,3,0,D2,282
D,Colombia,3,3,4,6,-2,D3,282
D,Costa Rica,3,1,3,6,-3,D4,282
A,Chile,3,7,6,3,3,A1,283
A,Argentina,3,6,4,3,1,A2,283
A,Peru,3,2,2,4,-2,A3,283
A,Canada,3,1,2,4,-2,A4,283
B,Ecuador,3,5,5,3,2,B1,283
B,Venezuela,3,5,2,1,1,B2,283
B,Mexico,3,4,4,3,1,B3,283
B,Jamaica,3,1,1,5,-4,B4,283
C,United States,3,7,6,2,4,C1,283
C,Panama,3,6,3,2,1,C2,283
C,Uruguay,3,4,5,4,1,C3,283
C,Bolivia,3,0,1,7,-6,C4,283
D,Colombia,3,7,6,2,4,D1,283
D,Brazil,3,6,7,2,5,D2,283
D,Costa Rica,3,2,2,4,-2,D3,283
D,Paraguay,3,1,2,9,-7,D4,283
A,Argentina,3,7,6,2,4,A1,284
A,Peru,3,6,3,3,0,A2,284
A,Chile,3,3,2,3,-1,A3,284
A,Canada,3,1,2,5,-3,A4,284
B,Ecuador,3,5,5,3,2,B1,284
B,Mexico,3,5,5,4,1,B2,284
B,Jamaica,3,3,4,4,0,B3,284
B,Venezuela,3,1,3,6,-3,B4,284
C,Uruguay,3,9,7,0,7,C1,284
C,United States,3,6,6,3,3,C2,284
C,Panama,3,3,1,4,-3,C3,284
C,Bolivia,3,0,1,8,-7,C4,284
D,Brazil,3,9,5,0,5,D1,284
D,Colombia,3,6,3,1,2,D2,284
D,Costa Rica,3,3,2,4,-2,D3,284
D,Paraguay,3,0,0,5,-5,D4,284
A,Peru,3,6,5,4,1,A1,285
A,Canada,3,5,3,0,3,A2,285
A,Argentina,3,4,4,2,2,A3,285
A,Chile,3,1,1,7,-6,A4,285
B,Mexico,3,7,5,2,3,B1,285
B,Jamaica,3,6,7,4,3,B2,285
B,Venezuela,3,3,5,8,-3,B3,285
B,Ecuador,3,1,2,5,-3,B4,285
C,Uruguay,3,7,3,0,3,C1,285
C,United States,3,6,4,3,1,C2,285
C,Bolivia,3,2,2,4,-2,C3,285
C,Panama,3,1,1,3,-2,C4,285
D,Brazil,3,7,7,4,3,D1,285
D,Costa Rica,3,4,3,3,0,D2,285
D,Colombia,3,2,1,2,-1,D3,285
D,Paraguay,3,2,2,4,-2,D4,285
A,Chile,3,6,4,3,1,A1,286
A,Argentina,3,4,5,4,1,A2,286
A,Peru,3,4,4,4,0,A3,286
A,Canada,3,3,3,5,-2,A4,286
B,Ecuador,3,7,7,3,4,B1,286
B,Mexico,3,5,5,4,1,B2,286
B,Venezuela,3,2,3,5,-2,B3,286
B,Jamaica,3,1,2,5,-3,B4,286
C,United States,3,7,8,3,5,C1,286
C,Uruguay,3,7,5,1,4,C2,286
C,Bolivia,3,3,3,5,-2,C3,286
C,Panama,3,0,0,7,-7,C4,286
D,Brazil,3,7,6,1,5,D1,286
D,Colombia,3,6,8,6,2,D2,286
D,Paraguay,3,2,2,6,-4,D3,286
D,Costa Rica,3,1,1,4,-3,D4,286
A,Argentina,3,9,11,3,8,A1,287
A,Peru,3,4,7,7,0,A2,287
A,Canada,3,4,4,4,0,A3,287
A,Chile,3,0,0,8,-8,A4,287
B,Venezuela,3,5,3,1,2,B1,287
B,Mexico,3,5,1,0,1,B2,287
B,Ecuador,3,3,1,1,0,B3,287
B,Jamaica,3,1,0,3,-3,B4,287
C,United States,3,7,6,1,5,C1,287
C,Uruguay,3,5,3,2,1,C2,287
C,Bolivia,3,2,2,6,-4,C3,287
C,Panama,3,1,1,3,-2,C4,287
D,Brazil,3,6,6,1,5,D1,287
D,Costa Rica,3,4,3,3,0,D2,287
D,Paraguay,3,4,4,8,-4,D3,287
D,Colombia,3,3,2,3,-1,D4,287
A,Argentina,3,5,2,1,1,A1,288
A,Chile,3,4,5,2,3,A2,288
A,Peru,3,3,1,1,0,A3,288
A,Canada,3,2,1,5,-4,A4,288
B,Venezuela,3,5,7,3,4,B1,288
B,Jamaica,3,4,5,5,0,B2,288
B,Ecuador,3,4,4,7,-3,B3,288
B,Mexico,3,2,0,1,-1,B4,288
C,Uruguay,3,9,8,3,5,C1,288
C,United States,3,6,6,4,2,C2,288
C,Panama,3,3,4,4,0,C3,288
C,Bolivia,3,0,2,9,-7,C4,288
D,Brazil,3,9,5,0,5,D1,288
D,Colombia,3,4,2,2,0,D2,288
D,Costa Rica,3,3,1,3,-2,D3,288
D,Paraguay,3,1,1,4,-3,D4,288
A,Chile,3,9,5,0,5,A1,289
A,Argentina,3,6,6,1,5,A2,289
A,Peru,3,1,0,3,-3,A3,289
A,Canada,3,1,0,7,-7,A4,289
B,Venezuela,3,5,4,2,2,B1,289
B,Mexico,3,4,6,3,3,B2,289
B,Ecuador,3,4,4,7,-3,B3,289
B,Jamaica,3,2,3,5,-2,B4,289
C,Uruguay,3,9,8,1,7,C1,289
C,United States,3,4,2,3,-1,C2,289
C,Panama,3,3,4,6,-2,C3,289
C,Bolivia,3,1,1,5,-4,C4,289
D,Brazil,3,7,5,0,5,D1,289
D,Costa Rica,3,4,3,6,-3,D2,289
D,Colombia,3,2,2,3,-1,D3,289
D,Paraguay,3,2,2,3,-1,D4,289
A,Chile,3,7,5,2,3,A1,290
A,Argentina,3,6,6,3,3,A2,290
A,Peru,3,4,3,3,0,A3,290
A,Canada,3,0,0,6,-6,A4,290
B,Venezuela,3,7,3,1,2,B1,290
B,Mexico,3,6,3,1,2,B2,290
B,Ecuador,3,4,2,3,-1,B3,290
B,Jamaica,3,0,0,3,-3,B4,290
C,United States,3,6,7,3,4,C1,290
C,Panama,3,6,5,5,0,C2,290
C,Uruguay,3,3,6,4,2,C3,290
C,Bolivia,3,3,3,9,-6,C4,290
D,Brazil,3,9,8,3,5,D1,290
D,Colombia,3,6,7,5,2,D2,290
D,Costa Rica,3,3,4,7,-3,D3,290
D,Paraguay,3,0,2,6,-4,D4,290
A,Argentina,3,9,8,0,8,A1,291
A,Chile,3,6,4,3,1,A2,291
A,Peru,3,1,3,7,-4,A3,291
A,Canada,3,1,3,8,-5,A4,291
B,Ecuador,3,6,4,2,2,B1,291
B,Venezuela,3,5,2,1,1,B2,291
B,Mexico,3,4,2,1,1,B3,291
B,Jamaica,3,1,0,4,-4,B4,291
C,Uruguay,3,6,4,3,1,C1,291
C,Panama,3,5,4,2,2,C2,291
C,United States,3,4,5,3,2,C3,291
C,Bolivia,3,1,1,6,-5,C4,291
D,Brazil,3,6,6,2,4,D1,291
D,Colombia,3,4,4,3,1,D2,291
D,Paraguay,3,4,2,3,-1,D3,291
D,Costa Rica,3,2,1,5,-4,D4,291
A,Argentina,3,5,7,6,1,A1,292
A,Chile,3,3,4,4,0,A2,292
A,Peru,3,3,3,3,0,A3,292
A,Canada,3,2,3,4,-1,A4,292
B,Mexico,3,9,5,1,4,B1,292
B,Ecuador,3,6,6,5,1,B2,292
B,Venezuela,3,3,5,7,-2,B3,292
B,Jamaica,3,0,1,4,-3,B4,292
C,Uruguay,3,9,6,0,6,C1,292
C,United States,3,4,3,4,-1,C2,292
C,Panama,3,2,2,4,-2,C3,292
C,Bolivia,3,1,2,5,-3,C4,292
D,Brazil,3,7,11,2,9,D1,292
D,Colombia,3,7,3,1,2,D2,292
D,Costa Rica,3,1,0,4,-4,D3,292
D,Paraguay,3,1,1,8,-7,D4,292
A,Argentina,3,7,4,0,4,A1,293
A,Peru,3,6,5,3,2,A2,293
A,Chile,3,3,3,5,-2,A3,293
A,Canada,3,1,0,4,-4,A4,293
B,Mexico,3,6,4,2,2,B1,293
B,Ecuador,3,4,4,3,1,B2,293
B,Venezuela,3,4,3,3,0,B3,293
B,Jamaica,3,3,2,5,-3,B4,293
C,United States,3,5,6,3,3,C1,293
C,Uruguay,3,5,5,2,3,C2,293
C,Bolivia,3,3,3,8,-5,C3,293
C,Panama,3,2,3,4,-1,C4,293
D,Brazil,3,7,6,2,4,D1,293
D,Colombia,3,5,2,1,1,D2,293
D,Costa Rica,3,4,2,4,-2,D3,293
D,Paraguay,3,0,2,5,-3,D4,293
A,Argentina,3,6,7,3,4,A1,294
A,Canada,3,6,5,4,1,A2,294
A,Peru,3,6,3,4,-1,A3,294
A,Chile,3,0,3,7,-4,A4,294
B,Mexico,3,7,6,2,4,B1,294
B,Ecuador,3,6,6,3,3,B2,294
B,Venezuela,3,4,5,5,0,B3,294
B,Jamaica,3,0,1,8,-7,B4,294
C,United States,3,9,7,2,5,C1,294
C,Uruguay,3,6,3,2,1,C2,294
C,Bolivia,3,1,1,3,-2,C3,294
C,Panama,3,1,0,4,-4,C4,294
D,Colombia,3,6,6,1,5,D1,294
D,Paraguay,3,6,5,5,0,D2,294
D,Brazil,3,4,3,3,0,D3,294
D,Costa Rica,3,1,3,8,-5,D4,294
A,Argentina,3,9,6,0,6,A1,295
A,Peru,3,4,3,2,1,A2,295
A,Chile,3,4,2,4,-2,A3,295
A,Canada,3,0,0,5,-5,A4,295
B,Venezuela,3,6,4,2,2,B1,295
B,Ecuador,3,5,4,3,1,B2,295
B,Jamaica,3,2,2,3,-1,B3,295
B,Mexico,3,2,2,4,-2,B4,295
C,United States,3,7,4,0,4,C1,295
C,Uruguay,3,5,3,0,3,C2,295
C,Bolivia,3,3,2,6,-4,C3,295
C,Panama,3,1,1,4,-3,C4,295
D,Brazil,3,6,8,2,6,D1,295
D,Colombia,3,6,4,7,-3,D2,295
D,Paraguay,3,4,8,5,3,D3,295
D,Costa Rica,3,1,0,6,-6,D4,295
A,Argentina,3,7,11,1,10,A1,296
A,Chile,3,6,5,7,-2,A2,296
A,Peru,3,4,4,3,1,A3,296
A,Canada,3,0,2,11,-9,A4,296
B,Ecuador,3,9,7,2,5,B1,296
B,Mexico,3,6,4,3,1,B2,296
B,Venezuela,3,3,5,6,-1,B3,296
B,Jamaica,3,0,2,7,-5,B4,296
C,Uruguay,3,9,8,2,6,C1,296
C,United States,3,6,7,6,1,C2,296
C,Bolivia,3,3,2,6,-4,C3,296
C,Panama,3,0,4,7,-3,C4,296
D,Brazil,3,7,3,0,3,D1,296
D,Paraguay,3,4,1,2,-1,D2,296
D,Colombia,3,2,1,2,-1,D3,296
D,Costa Rica,3,2,1,2,-1,D4,296
A,Argentina,3,9,5,2,3,A1,297
A,Peru,3,6,7,3,4,A2,297
A,Canada,3,1,3,6,-3,A3,297
A,Chile,3,1,3,7,-4,A4,297
B,Ecuador,3,7,4,0,4,B1,297
B,Mexico,3,4,8,4,4,B2,297
B,Jamaica,3,2,4,7,-3,B3,297
B,Venezuela,3,2,3,8,-5,B4,297
C,Uruguay,3,9,10,5,5,C1,297
C,United States,3,3,7,4,3,C2,297
C,Panama,3,3,2,5,-3,C3,297
C,Bolivia,3,3,3,8,-5,C4,297
D,Colombia,3,7,8,3,5,D1,297
D,Brazil,3,7,6,1,5,D2,297
D,Paraguay,3,3,2,7,-5,D3,297
D,Costa Rica,3,0,1,6,-5,D4,297
A,Argentina,3,6,6,4,2,A1,298
A,Peru,3,6,4,3,1,A2,298
A,Chile,3,3,3,4,-1,A3,298
A,Canada,3,3,4,6,-2,A4,298
B,Mexico,3,9,9,2,7,B1,298
B,Ecuador,3,4,5,4,1,B2,298
B,Jamaica,3,2,3,4,-1,B3,298
B,Venezuela,3,1,3,10,-7,B4,298
C,United States,3,9,6,2,4,C1,298
C,Bolivia,3,4,3,4,-1,C2,298
C,Uruguay,3,3,3,2,1,C3,298
C,Panama,3,1,4,8,-4,C4,298
D,Brazil,3,9,9,0,9,D1,298
D,Colombia,3,6,5,2,3,D2,298
D,Costa Rica,3,3,4,8,-4,D3,298
D,Paraguay,3,0,1,9,-8,D4,298
A,Argentina,3,7,4,1,3,A1,299
A,Peru,3,4,3,3,0,A2,299
A,Chile,3,4,1,1,0,A3,299
A,Canada,3,1,1,4,-3,A4,299
B,Mexico,3,7,5,2,3,B1,299
B,Ecuador,3,4,5,4,1,B2,299
B,Jamaica,3,4,3,4,-1,B3,299
B,Venezuela,3,1,3,6,-3,B4,299
C,Uruguay,3,9,7,2,5,C1,299
C,United States,3,4,6,4,2,C2,299
C,Bolivia,3,3,4,7,-3,C3,299
C,Panama,3,1,2,6,-4,C4,299
D,Brazil,3,9,11,4,7,D1,299
D,Costa Rica,3,6,5,5,0,D2,299
D,Colombia,3,1,4,7,-3,D3,299
D,Paraguay,3,1,4,8,-4,D4,299
A,Argentina,3,9,8,2,6,A1,300
A,Chile,3,4,3,5,-2,A2,300
A,Canada,3,3,3,4,-1,A3,300
A,Peru,3,1,2,5,-3,A4,300
B,Venezuela,3,9,7,1,6,B1,300
B,Ecuador,3,6,5,4,1,B2,300
B,Mexico,3,3,4,6,-2,B3,300
B,Jamaica,3,0,1,6,-5,B4,300
C,Uruguay,3,7,7,3,4,C1,300
C,United States,3,6,4,2,2,C2,300
C,Panama,3,4,3,3,0,C3,300
C,Bolivia,3,0,1,7,-6,C4,300
D,Brazil,3,7,12,3,9,D1,300
D,Colombia,3,5,2,1,1,D2,300
D,Paraguay,3,4,4,3,1,D3,300
D,Costa Rica,3,0,0,11,-11,D4,300
A,Argentina,3,7,4,1,3,A1,301
A,Chile,3,5,4,1,3,A2,301
A,Peru,3,4,2,3,-1,A3,301
A,Canada,3,0,1,6,-5,A4,301
B,Ecuador,3,6,9,3,6,B1,301
B,Mexico,3,6,4,3,1,B2,301
B,Jamaica,3,4,4,7,-3,B3,301
B,Venezuela,3,1,1,5,-4,B4,301
C,Uruguay,3,9,8,0,8,C1,301
C,United States,3,6,6,3,3,C2,301
C,Bolivia,3,3,4,10,-6,C3,301
C,Panama,3,0,3,8,-5,C4,301
D,Brazil,3,7,4,1,3,D1,301
D,Colombia,3,7,3,1,2,D2,301
D,Costa Rica,3,1,3,5,-2,D3,301
D,Paraguay,3,1,3,6,-3,D4,301
A,Argentina,3,7,5,2,3,A1,302
A,Chile,3,5,4,2,2,A2,302
A,Peru,3,4,2,1,1,A3,302
A,Canada,3,0,0,6,-6,A4,302
B,Mexico,3,7,4,0,4,B1,302
B,Ecuador,3,4,6,3,3,B2,302
B,Venezuela,3,4,2,3,-1,B3,302
B,Jamaica,3,1,0,6,-6,B4,302
C,Bolivia,3,6,7,2,5,C1,302
C,United States,3,6,7,4,3,C2,302
C,Uruguay,3,6,5,4,1,C3,302
C,Panama,3,0,0,9,-9,C4,302
D,Brazil,3,7,9,0,9,D1,302
D,Colombia,3,7,4,0,4,D2,302
D,Paraguay,3,1,0,6,-6,D3,302
D,Costa Rica,3,1,0,7,-7,D4,302
A,Argentina,3,9,9,2,7,A1,303
A,Chile,3,4,3,4,-1,A2,303
A,Peru,3,4,4,6,-2,A3,303
A,Canada,3,0,2,6,-4,A4,303
B,Venezuela,3,7,6,1,5,B1,303
B,Mexico,3,6,3,4,-1,B2,303
B,Ecuador,3,4,3,3,0,B3,303
B,Jamaica,3,0,2,6,-4,B4,303
C,United States,3,7,7,4,3,C1,303
C,Uruguay,3,6,9,4,5,C2,303
C,Panama,3,2,2,6,-4,C3,303
C,Bolivia,3,1,3,7,-4,C4,303
D,Colombia,3,6,3,2,1,D1,303
D,Brazil,3,4,2,1,1,D2,303
D,Costa Rica,3,4,2,2,0,D3,303
D,Paraguay,3,3,3,5,-2,D4,303
A,Argentina,3,9,8,2,6,A1,304
A,Canada,3,6,6,6,0,A2,304
A,Chile,3,1,2,5,-3,A3,304
A,Peru,3,1,2,5,-3,A4,304
B,Ecuador,3,7,6,2,4,B1,304
B,Mexico,3,5,2,1,1,B2,304
B,Venezuela,3,4,4,4,0,B3,304
B,Jamaica,3,0,1,6,-5,B4,304
C,Uruguay,3,7,3,0,3,C1,304
C,Panama,3,4,1,3,-2,C2,304
C,United States,3,3,3,2,1,C3,304
C,Bolivia,3,3,1,3,-2,C4,304
D,Brazil,3,7,8,4,4,D1,304
D,Colombia,3,6,3,4,-1,D2,304
D,Paraguay,3,4,3,2,1,D3,304
D,Costa Rica,3,0,2,6,-4,D4,304
A,Chile,3,7,3,0,3,A1,305
A,Argentina,3,6,4,3,1,A2,305
A,Canada,3,3,2,3,-1,A3,305
A,Peru,3,1,0,3,-3,A4,305
B,Mexico,3,7,4,1,3,B1,305
B,Ecuador,3,5,4,2,2,B2,305
B,Venezuela,3,3,5,4,1,B3,305
B,Jamaica,3,1,2,8,-6,B4,305
C,Uruguay,3,9,4,0,4,C1,305
C,United States,3,4,4,3,1,C2,305
C,Bolivia,3,3,2,5,-3,C3,305
C,Panama,3,1,3,5,-2,C4,305
D,Brazil,3,5,6,2,4,D1,305
D,Colombia,3,4,3,2,1,D2,305
D,Paraguay,3,4,2,4,-2,D3,305
D,Costa Rica,3,3,3,6,-3,D4,305
A,Chile,3,5,4,2,2,A1,306
A,Peru,3,4,6,5,1,A2,306
A,Argentina,3,3,2,2,0,A3,306
A,Canada,3,2,1,4,-3,A4,306
B,Mexico,3,7,9,6,3,B1,306
B,Venezuela,3,6,9,3,6,B2,306
B,Ecuador,3,3,3,5,-2,B3,306
B,Jamaica,3,1,4,11,-7,B4,306
C,United States,3,7,7,2,5,C1,306
C,Panama,3,5,3,2,1,C2,306
C,Uruguay,3,4,2,1,1,C3,306
C,Bolivia,3,0,2,9,-7,C4,306
D,Brazil,3,9,10,0,10,D1,306
D,Costa Rica,3,6,4,5,-1,D2,306
D,Colombia,3,3,1,3,-2,D3,306
D,Paraguay,3,0,0,7,-7,D4,306
A,Argentina,3,9,7,2,5,A1,307
A,Peru,3,3,6,4,2,A2,307
A,Chile,3,3,2,3,-1,A3,307
A,Canada,3,3,2,8,-6,A4,307
B,Ecuador,3,7,3,1,2,B1,307
B,Venezuela,3,5,4,2,2,B2,307
B,Mexico,3,4,4,2,2,B3,307
B,Jamaica,3,0,0,6,-6,B4,307
C,United States,3,9,11,1,10,C1,307
C,Uruguay,3,6,6,3,3,C2,307
C,Bolivia,3,3,3,10,-7,C3,307
C,Panama,3,0,3,9,-6,C4,307
D,Paraguay,3,7,4,2,2,D1,307
D,Costa Rica,3,5,3,2,1,D2,307
D,Brazil,3,3,3,3,0,D3,307
D,Colombia,3,1,1,4,-3,D4,307
A,Argentina,3,9,5,1,4,A1,308
A,Chile,3,4,4,2,2,A2,308
A,Peru,3,2,4,5,-1,A3,308
A,Canada,3,1,2,7,-5,A4,308
B,Ecuador,3,9,8,2,6,B1,308
B,Mexico,3,6,9,2,7,B2,308
B,Venezuela,3,1,1,4,-3,B3,308
B,Jamaica,3,1,0,10,-10,B4,308
C,United States,3,6,4,1,3,C1,308
C,Uruguay,3,4,3,2,1,C2,308
C,Bolivia,3,4,3,3,0,C3,308
C,Panama,3,3,2,6,-4,C4,308
D,Brazil,3,7,5,1,4,D1,308
D,Costa Rica,3,4,5,6,-1,D2,308
D,Colombia,3,2,3,4,-1,D3,308
D,Paraguay,3,2,1,3,-2,D4,308
A,Argentina,3,9,8,1,7,A1,309
A,Peru,3,4,3,5,-2,A2,309
A,Canada,3,3,3,5,-2,A3,309
A,Chile,3,1,1,4,-3,A4,309
B,Mexico,3,5,3,2,1,B1,309
B,Jamaica,3,5,1,0,1,B2,309
B,Venezuela,3,4,2,2,0,B3,309
B,Ecuador,3,1,1,3,-2,B4,309
C,Uruguay,3,7,7,4,3,C1,309
C,United States,3,5,5,4,1,C2,309
C,Panama,3,2,4,6,-2,C3,309
C,Bolivia,3,1,4,6,-2,C4,309
D,Brazil,3,7,3,1,2,D1,309
D,Colombia,3,4,5,3,2,D2,309
D,Costa Rica,3,2,2,3,-1,D3,309
D,Paraguay,3,2,1,4,-3,D4,309
A,Argentina,3,9,8,3,5,A1,310
A,Peru,3,4,4,4,0,A2,310
A,Chile,3,4,3,4,-1,A3,310
A,Canada,3,0,2,6,-4,A4,310
B,Mexico,3,7,7,2,5,B1,310
B,Ecuador,3,7,5,2,3,B2,310
B,Venezuela,3,3,5,5,0,B3,310
B,Jamaica,3,0,1,9,-8,B4,310
C,United States,3,7,10,2,8,C1,310
C,Uruguay,3,6,7,4,3,C2,310
C,Bolivia,3,3,4,10,-6,C3,310
C,Panama,3,1,1,6,-5,C4,310
D,Colombia,3,7,11,4,7,D1,310
D,Brazil,3,7,4,2,2,D2,310
D,Paraguay,3,1,0,4,-4,D3,310
D,Costa Rica,3,1,2,7,-5,D4,310
A,Chile,3,7,5,2,3,A1,311
A,Argentina,3,4,4,2,2,A2,311
A,Canada,3,2,1,3,-2,A3,311
A,Peru,3,2,2,5,-3,A4,311
B,Mexico,3,7,5,1,4,B1,311
B,Venezuela,3,6,4,3,1,B2,311
B,Jamaica,3,2,1,3,-2,B3,311
B,Ecuador,3,1,1,4,-3,B4,311
C,Uruguay,3,9,5,0,5,C1,311
C,Bolivia,3,4,3,3,0,C2,311
C,United States,3,4,3,4,-1,C3,311
C,Panama,3,0,2,6,-4,C4,311
D,Brazil,3,9,8,2,6,D1,311
D,Costa Rica,3,6,6,4,2,D2,311
D,Colombia,3,3,3,4,-1,D3,311
D,Paraguay,3,0,1,8,-7,D4,311
A,Chile,3,7,4,1,3,A1,312
A,Argentina,3,4,5,3,2,A2,312
A,Peru,3,4,3,4,-1,A3,312
A,Canada,3,1,1,5,-4,A4,312
B,Ecuador,3,6,5,2,3,B1,312
B,Venezuela,3,6,4,2,2,B2,312
B,Jamaica,3,6,2,2,0,B3,312
B,Mexico,3,0,1,6,-5,B4,312
C,Panama,3,6,3,3,0,C1,312
C,Bolivia,3,4,5,4,1,C2,312
C,Uruguay,3,4,4,3,1,C3,312
C,United States,3,3,3,5,-2,C4,312
D,Brazil,3,9,6,1,5,D1,312
D,Colombia,3,4,4,4,0,D2,312
D,Costa Rica,3,4,4,4,0,D3,312
D,Paraguay,3,0,2,7,-5,D4,312
A,Argentina,3,9,8,1,7,A1,313
A,Canada,3,4,2,5,-3,A2,313
A,Chile,3,3,5,6,-1,A3,313
A,Peru,3,1,2,5,-3,A4,313
B,Jamaica,3,7,3,1,2,B1,313
B,Venezuela,3,4,5,5,0,B2,313
B,Mexico,3,4,4,4,0,B3,313
B,Ecuador,3,1,0,2,-2,B4,313
C,Uruguay,3,7,9,5,4,C1,313
C,Bolivia,3,4,3,5,-2,C2,313
C,Panama,3,3,6,6,0,C3,313
C,United States,3,3,4,6,-2,C4,313
D,Brazil,3,6,5,2,3,D1,313
D,Colombia,3,4,4,3,1,D2,313
D,Costa Rica,3,4,4,7,-3,D3,313
D,Paraguay,3,3,2,3,-1,D4,313
A,Chile,3,9,5,0,5,A1,314
A,Canada,3,4,3,1,2,A2,314
A,Peru,3,3,1,4,-3,A3,314
A,Argentina,3,1,0,4,-4,A4,314
B,Ecuador,3,9,5,1,4,B1,314
B,Mexico,3,6,4,3,1,B2,314
B,Venezuela,3,3,2,4,-2,B3,314
B,Jamaica,3,0,2,5,-3,B4,314
C,Uruguay,3,9,12,3,9,C1,314
C,Bolivia,3,2,3,4,-1,C2,314
C,Panama,3,2,2,6,-4,C3,314
C,United States,3,2,2,6,-4,C4,314
D,Brazil,3,9,5,0,5,D1,314
D,Colombia,3,6,4,2,2,D2,314
D,Costa Rica,3,3,1,4,-3,D3,314
D,Paraguay,3,0,1,5,-4,D4,314
A,Argentina,3,7,8,3,5,A1,315
A,Chile,3,3,3,3,0,A2,315
A,Canada,3,2,2,4,-2,A3,315
A,Peru,3,2,2,5,-3,A4,315
B,Mexico,3,9,7,2,5,B1,315
B,Ecuador,3,4,2,1,1,B2,315
B,Jamaica,3,2,2,3,-1,B3,315
B,Venezuela,3,1,2,7,-5,B4,315
C,Uruguay,3,7,5,2,3,C1,315
C,United States,3,7,5,3,2,C2,315
C,Bolivia,3,3,2,4,-2,C3,315
C,Panama,3,0,0,3,-3,C4,315
D,Brazil,3,7,4,1,3,D1,315
D,Paraguay,3,6,4,2,2,D2,315
D,Colombia,3,3,5,5,0,D3,315
D,Costa Rica,3,1,3,8,-5,D4,315
A,Chile,3,5,4,3,1,A1,316
A,Canada,3,4,6,5,1,A2,316
A,Argentina,3,4,5,5,0,A3,316
A,Peru,3,3,1,3,-2,A4,316
B,Mexico,3,9,6,1,5,B1,316
B,Ecuador,3,4,5,4,1,B2,316
B,Venezuela,3,3,4,7,-3,B3,316
B,Jamaica,3,1,3,6,-3,B4,316
C,United States,3,7,5,1,4,C1,316
C,Uruguay,3,7,4,1,3,C2,316
C,Bolivia,3,1,2,5,-3,C3,316
C,Panama,3,1,2,6,-4,C4,316
D,Colombia,3,6,5,1,4,D1,316
D,Brazil,3,6,3,4,-1,D2,316
D,Costa Rica,3,3,2,3,-1,D3,316
D,Paraguay,3,3,2,4,-2,D4,316
A,Argentina,3,7,6,1,5,A1,317
A,Canada,3,4,3,4,-1,A2,317
A,Peru,3,3,2,2,0,A3,317
A,Chile,3,1,1,5,-4,A4,317
B,Venezuela,3,7,6,2,4,B1,317
B,Mexico,3,5,3,2,1,B2,317
B,Ecuador,3,4,5,5,0,B3,317
B,Jamaica,3,0,2,7,-5,B4,317
C,Uruguay,3,7,10,5,5,C1,317
C,United States,3,7,5,0,5,C2,317
C,Bolivia,3,3,8,10,-2,C3,317
C,Panama,3,0,4,12,-8,C4,317
D,Brazil,3,9,9,2,7,D1,317
D,Colombia,3,6,4,4,0,D2,317
D,Costa Rica,3,1,3,6,-3,D3,317
D,Paraguay,3,1,2,6,-4,D4,317
A,Peru,3,7,5,3,2,A1,318
A,Chile,3,6,6,3,3,A2,318
A,Argentina,3,4,5,5,0,A3,318
A,Canada,3,0,3,8,-5,A4,318
B,Mexico,3,7,2,0,2,B1,318
B,Ecuador,3,6,4,2,2,B2,318
B,Venezuela,3,4,4,3,1,B3,318
B,Jamaica,3,0,0,5,-5,B4,318
C,Uruguay,3,7,3,0,3,C1,318
C,United States,3,6,6,1,5,C2,318
C,Panama,3,4,2,3,-1,C3,318
C,Bolivia,3,0,0,7,-7,C4,318
D,Brazil,3,6,5,3,2,D1,318
D,Colombia,3,6,4,2,2,D2,318
D,Paraguay,3,4,1,2,-1,D3,318
D,Costa Rica,3,1,1,4,-3,D4,318
A,Argentina,3,7,6,1,5,A1,319
A,Canada,3,4,1,3,-2,A2,319
A,Chile,3,3,1,1,0,A3,319
A,Peru,3,1,0,3,-3,A4,319
B,Mexico,3,5,8,7,1,B1,319
B,Jamaica,3,4,4,3,1,B2,319
B,Venezuela,3,4,5,6,-1,B3,319
B,Ecuador,3,3,4,5,-1,B4,319
C,Uruguay,3,6,8,3,5,C1,319
C,Panama,3,6,3,2,1,C2,319
C,United States,3,6,5,5,0,C3,319
C,Bolivia,3,0,2,8,-6,C4,319
D,Brazil,3,9,12,3,9,D1,319
D,Costa Rica,3,4,5,5,0,D2,319
D,Colombia,3,2,1,4,-3,D3,319
D,Paraguay,3,1,1,7,-6,D4,319
A,Peru,3,5,6,5,1,A1,320
A,Chile,3,3,5,5,0,A2,320
A,Canada,3,3,4,4,0,A3,320
A,Argentina,3,2,2,3,-1,A4,320
B,Mexico,3,7,5,2,3,B1,320
B,Venezuela,3,4,4,3,1,B2,320
B,Ecuador,3,3,3,6,-3,B3,320
B,Jamaica,3,2,2,3,-1,B4,320
C,Uruguay,3,7,6,4,2,C1,320
C,United States,3,4,7,5,2,C2,320
C,Bolivia,3,3,3,5,-2,C3,320
C,Panama,3,2,5,7,-2,C4,320
D,Colombia,3,9,6,0,6,D1,320
D,Brazil,3,4,2,4,-2,D2,320
D,Paraguay,3,2,0,1,-1,D3,320
D,Costa Rica,3,1,1,4,-3,D4,320
A,Argentina,3,7,4,2,2,A1,321
A,Canada,3,6,5,3,2,A2,321
A,Chile,3,4,3,2,1,A3,321
A,Peru,3,0,1,6,-5,A4,321
B,Mexico,3,7,6,1,5,B1,321
B,Venezuela,3,6,4,2,2,B2,321
B,Ecuador,3,4,3,4,-1,B3,321
B,Jamaica,3,0,0,6,-6,B4,321
C,Uruguay,3,7,7,1,6,C1,321
C,Panama,3,4,3,5,-2,C2,321
C,United States,3,3,2,2,0,C3,321
C,Bolivia,3,1,2,6,-4,C4,321
D,Colombia,3,9,7,1,6,D1,321
D,Brazil,3,6,6,2,4,D2,321
D,Costa Rica,3,3,1,5,-4,D3,321
D,Paraguay,3,0,1,7,-6,D4,321
A,Argentina,3,7,8,3,5,A1,322
A,Chile,3,5,4,3,1,A2,322
A,Peru,3,3,5,6,-1,A3,322
A,Canada,3,1,3,8,-5,A4,322
B,Mexico,3,9,9,4,5,B1,322
B,Venezuela,3,6,5,4,1,B2,322
B,Jamaica,3,3,1,4,-3,B3,322
B,Ecuador,3,0,3,6,-3,B4,322
C,Uruguay,3,7,7,3,4,C1,322
C,United States,3,4,9,4,5,C2,322
C,Bolivia,3,4,3,4,-1,C3,322
C,Panama,3,1,2,10,-8,C4,322
D,Colombia,3,9,9,2,7,D1,322
D,Brazil,3,4,5,3,2,D2,322
D,Paraguay,3,3,4,10,-6,D3,322
D,Costa Rica,3,1,2,5,-3,D4,322
A,Peru,3,5,5,4,1,A1,323
A,Chile,3,4,4,4,0,A2,323
A,Canada,3,4,3,6,-3,A3,323
A,Argentina,3,3,5,3,2,A4,323
B,Mexico,3,9,5,1,4,B1,323
B,Ecuador,3,4,1,2,-1,B2,323
B,Venezuela,3,2,1,2,-1,B3,323
B,Jamaica,3,1,0,2,-2,B4,323
C,United States,3,7,5,1,4,C1,323
C,Uruguay,3,6,5,2,3,C2,323
C,Panama,3,4,5,3,2,C3,323
C,Bolivia,3,0,0,9,-9,C4,323
D,Brazil,3,9,9,1,8,D1,323
D,Colombia,3,6,7,2,5,D2,323
D,Paraguay,3,1,0,5,-5,D3,323
D,Costa Rica,3,1,0,8,-8,D4,323
A,Argentina,3,7,4,0,4,A1,324
A,Canada,3,4,4,3,1,A2,324
A,Chile,3,4,3,3,0,A3,324
A,Peru,3,1,1,6,-5,A4,324
B,Mexico,3,5,5,1,4,B1,324
B,Ecuador,3,5,3,2,1,B2,324
B,Venezuela,3,4,4,3,1,B3,324
B,Jamaica,3,1,1,7,-6,B4,324
C,Uruguay,3,9,11,3,8,C1,324
C,United States,3,4,4,4,0,C2,324
C,Bolivia,3,4,5,9,-4,C3,324
C,Panama,3,0,1,5,-4,C4,324
D,Colombia,3,7,5,1,4,D1,324
D,Paraguay,3,4,4,2,2,D2,324
D,Costa Rica,3,3,2,7,-5,D3,324
D,Brazil,3,2,1,2,-1,D4,324
A,Peru,3,5,3,1,2,A1,325
A,Argentina,3,4,2,3,-1,A2,325
A,Canada,3,4,2,3,-1,A3,325
A,Chile,3,3,3,3,0,A4,325
B,Mexico,3,6,5,4,1,B1,325
B,Ecuador,3,6,2,1,1,B2,325
B,Venezuela,3,3,3,4,-1,B3,325
B,Jamaica,3,3,2,3,-1,B4,325
C,United States,3,9,6,2,4,C1,325
C,Uruguay,3,6,7,3,4,C2,325
C,Panama,3,3,2,4,-2,C3,325
C,Bolivia,3,0,3,9,-6,C4,325
D,Colombia,3,9,8,2,6,D1,325
D,Brazil,3,6,5,1,4,D2,325
D,Paraguay,3,3,4,6,-2,D3,325
D,Costa Rica,3,0,1,9,-8,D4,325
A,Argentina,3,7,5,1,4,A1,326
A,Chile,3,6,5,5,0,A2,326
A,Peru,3,2,2,3,-1,A3,326
A,Canada,3,1,2,5,-3,A4,326
B,Jamaica,3,5,3,2,1,B1,326
B,Ecuador,3,4,3,3,0,B2,326
B,Mexico,3,4,2,2,0,B3,326
B,Venezuela,3,2,3,4,-1,B4,326
C,Uruguay,3,7,6,2,4,C1,326
C,Panama,3,5,4,3,1,C2,326
C,Bolivia,3,3,2,3,-1,C3,326
C,United States,3,1,3,7,-4,C4,326
D,Brazil,3,6,5,3,2,D1,326
D,Costa Rica,3,4,4,5,-1,D2,326
D,Paraguay,3,4,2,3,-1,D3,326
D,Colombia,3,3,3,3,0,D4,326
A,Chile,3,7,7,4,3,A1,327
A,Peru,3,6,4,3,1,A2,327
A,Argentina,3,4,4,4,0,A3,327
A,Canada,3,0,1,5,-4,A4,327
B,Ecuador,3,6,5,4,1,B1,327
B,Venezuela,3,4,4,3,1,B2,327
B,Mexico,3,4,4,5,-1,B3,327
B,Jamaica,3,2,5,6,-1,B4,327
C,United States,3,9,7,3,4,C1,327
C,Bolivia,3,4,5,4,1,C2,327
C,Uruguay,3,4,3,3,0,C3,327
C,Panama,3,0,2,7,-5,C4,327
D,Brazil,3,7,5,2,3,D1,327
D,Colombia,3,4,4,5,-1,D2,327
D,Paraguay,3,3,3,3,0,D3,327
D,Costa Rica,3,1,2,4,-2,D4,327
A,Argentina,3,9,7,2,5,A1,328
A,Peru,3,6,4,5,-1,A2,328
A,Chile,3,3,5,6,-1,A3,328
A,Canada,3,0,2,5,-3,A4,328
B,Mexico,3,6,4,1,3,B1,328
B,Jamaica,3,4,2,2,0,B2,328
B,Ecuador,3,4,3,4,-1,B3,328
B,Venezuela,3,3,2,4,-2,B4,328
C,Uruguay,3,7,5,2,3,C1,328
C,United States,3,6,7,3,4,C2,328
C,Bolivia,3,3,2,6,-4,C3,328
C,Panama,3,1,1,4,-3,C4,328
D,Brazil,3,5,6,2,4,D1,328
D,Paraguay,3,5,6,4,2,D2,328
D,Colombia,3,3,3,3,0,D3,328
D,Costa Rica,3,1,1,7,-6,D4,328
A,Chile,3,7,5,3,2,A1,329
A,Peru,3,5,4,2,2,A2,329
A,Argentina,3,2,2,3,-1,A3,329
A,Canada,3,1,3,6,-3,A4,329
B,Venezuela,3,9,6,2,4,B1,329
B,Ecuador,3,4,7,5,2,B2,329
B,Mexico,3,4,3,3,0,B3,329
B,Jamaica,3,0,3,9,-6,B4,329
C,Panama,3,9,5,1,4,C1,329
C,United States,3,4,4,2,2,C2,329
C,Bolivia,3,3,1,4,-3,C3,329
C,Uruguay,3,1,0,3,-3,C4,329
D,Brazil,3,9,12,3,9,D1,329
D,Colombia,3,3,3,5,-2,D2,329
D,Paraguay,3,3,3,5,-2,D3,329
D,Costa Rica,3,3,2,7,-5,D4,329
A,Chile,3,9,5,2,3,A1,330
A,Peru,3,4,2,1,1,A2,330
A,Argentina,3,2,2,3,-1,A3,330
A,Canada,3,1,2,5,-3,A4,330
B,Mexico,3,6,4,2,2,B1,330
B,Ecuador,3,5,2,1,1,B2,330
B,Venezuela,3,4,2,2,0,B3,330
B,Jamaica,3,1,1,4,-3,B4,330
C,Panama,3,5,4,3,1,C1,330
C,Uruguay,3,4,9,7,2,C2,330
C,United States,3,4,6,5,1,C3,330
C,Bolivia,3,2,4,8,-4,C4,330
D,Colombia,3,9,5,0,5,D1,330
D,Paraguay,3,4,2,2,0,D2,330
D,Costa Rica,3,3,1,4,-3,D3,330
D,Brazil,3,1,1,3,-2,D4,330
A,Argentina,3,9,7,0,7,A1,331
A,Canada,3,6,5,2,3,A2,331
A,Chile,3,3,3,8,-5,A3,331
A,Peru,3,0,2,7,-5,A4,331
B,Mexico,3,9,7,2,5,B1,331
B,Venezuela,3,3,5,6,-1,B2,331
B,Jamaica,3,3,4,5,-1,B3,331
B,Ecuador,3,3,3,6,-3,B4,331
C,Uruguay,3,7,9,1,8,C1,331
C,United States,3,7,9,3,6,C2,331
C,Bolivia,3,3,5,10,-5,C3,331
C,Panama,3,0,1,10,-9,C4,331
D,Brazil,3,6,8,4,4,D1,331
D,Colombia,3,5,4,3,1,D2,331
D,Paraguay,3,4,5,4,1,D3,331
D,Costa Rica,3,1,1,7,-6,D4,331
A,Canada,3,5,2,1,1,A1,332
A,Chile,3,4,2,1,1,A2,332
A,Peru,3,3,0,0,0,A3,332
A,Argentina,3,2,1,3,-2,A4,332
B,Jamaica,3,6,3,4,-1,B1,332
B,Mexico,3,5,5,2,3,B2,332
B,Ecuador,3,4,3,3,0,B3,332
B,Venezuela,3,1,1,3,-2,B4,332
C,United States,3,7,5,3,2,C1,332
C,Uruguay,3,5,3,2,1,C2,332
C,Panama,3,3,4,5,-1,C3,332
C,Bolivia,3,1,2,4,-2,C4,332
D,Brazil,3,7,9,3,6,D1,332
D,Colombia,3,7,6,4,2,D2,332
D,Paraguay,3,3,5,9,-4,D3,332
D,Costa Rica,3,0,1,5,-4,D4,332
A,Chile,3,7,6,0,6,A1,333
A,Argentina,3,7,3,1,2,A2,333
A,Peru,3,3,1,5,-4,A3,333
A,Canada,3,0,1,5,-4,A4,333
B,Mexico,3,5,4,3,1,B1,333
B,Venezuela,3,4,3,3,0,B2,333
B,Jamaica,3,4,2,2,0,B3,333
B,Ecuador,3,2,2,3,-1,B4,333
C,Uruguay,3,7,5,0,5,C1,333
C,United States,3,7,6,2,4,C2,333
C,Panama,3,3,3,6,-3,C3,333
C,Bolivia,3,0,2,8,-6,C4,333
D,Brazil,3,7,4,0,4,D1,333
D,Colombia,3,6,3,4,-1,D2,333
D,Costa Rica,3,2,0,1,-1,D3,333
D,Paraguay,3,1,1,3,-2,D4,333
A,Chile,3,4,2,1,1,A1,334
A,Canada,3,4,3,3,0,A2,334
A,Argentina,3,4,1,2,-1,A3,334
A,Peru,3,3,1,1,0,A4,334
B,Ecuador,3,6,7,4,3,B1,334
B,Mexico,3,6,5,3,2,B2,334
B,Venezuela,3,6,4,3,1,B3,334
B,Jamaica,3,0,1,7,-6,B4,334
C,United States,3,9,9,1,8,C1,334
C,Uruguay,3,4,5,4,1,C2,334
C,Panama,3,3,4,8,-4,C3,334
C,Bolivia,3,1,1,6,-5,C4,334
D,Brazil,3,7,5,0,5,D1,334
D,Colombia,3,5,4,2,2,D2,334
D,Costa Rica,3,4,3,5,-2,D3,334
D,Paraguay,3,0,2,7,-5,D4,334
A,Argentina,3,9,7,1,6,A1,335
A,Chile,3,3,4,5,-1,A2,335
A,Canada,3,3,3,5,-2,A3,335
A,Peru,3,3,3,6,-3,A4,335
B,Venezuela,3,7,6,2,4,B1,335
B,Mexico,3,6,4,2,2,B2,335
B,Jamaica,3,4,6,5,1,B3,335
B,Ecuador,3,0,0,7,-7,B4,335
C,Uruguay,3,9,6,0,6,C1,335
C,United States,3,4,3,1,2,C2,335
C,Panama,3,4,1,3,-2,C3,335
C,Bolivia,3,0,0,6,-6,C4,335
D,Brazil,3,6,11,5,6,D1,335
D,Paraguay,3,4,3,3,0,D2,335
D,Costa Rica,3,4,2,6,-4,D3,335
D,Colombia,3,3,3,5,-2,D4,335
A,Argentina,3,9,6,0,6,A1,336
A,Chile,3,6,4,3,1,A2,336
A,Peru,3,1,1,4,-3,A3,336
A,Canada,3,1,0,4,-4,A4,336
B,Venezuela,3,6,3,4,-1,B1,336
B,Jamaica,3,4,6,5,1,B2,336
B,Mexico,3,4,5,4,1,B3,336
B,Ecuador,3,3,5,6,-1,B4,336
C,Panama,3,7,5,2,3,C1,336
C,United States,3,6,3,2,1,C2,336
C,Uruguay,3,3,3,4,-1,C3,336
C,Bolivia,3,1,0,3,-3,C4,336
D,Brazil,3,9,6,1,5,D1,336
D,Colombia,3,6,4,3,1,D2,336
D,Paraguay,3,1,2,4,-2,D3,336
D,Costa Rica,3,1,0,4,-4,D4,336
A,Chile,3,7,4,1,3,A1,337
A,Argentina,3,5,5,3,2,A2,337
A,Canada,3,4,2,3,-1,A3,337
A,Peru,3,0,1,5,-4,A4,337
B,Mexico,3,7,7,2,5,B1,337
B,Ecuador,3,4,4,4,0,B2,337
B,Jamaica,3,3,2,6,-4,B3,337
B,Venezuela,3,2,3,4,-1,B4,337
C,Panama,3,7,5,2,3,C1,337
C,Bolivia,3,4,6,5,1,C2,337
C,Uruguay,3,4,6,6,0,C3,337
C,United States,3,1,6,10,-4,C4,337
D,Brazil,3,9,6,0,6,D1,337
D,Colombia,3,6,3,2,1,D2,337
D,Costa Rica,3,1,0,3,-3,D3,337
D,Paraguay,3,1,0,4,-4,D4,337
A,Argentina,3,7,4,1,3,A1,338
A,Chile,3,5,3,2,1,A2,338
A,Peru,3,3,2,4,-2,A3,338
A,Canada,3,1,0,2,-2,A4,338
B,Mexico,3,6,5,2,3,B1,338
B,Ecuador,3,5,2,1,1,B2,338
B,Venezuela,3,4,5,6,-1,B3,338
B,Jamaica,3,1,2,5,-3,B4,338
C,Uruguay,3,6,6,3,3,C1,338
C,Bolivia,3,6,6,6,0,C2,338
C,United States,3,4,6,6,0,C3,338
C,Panama,3,1,2,5,-3,C4,338
D,Brazil,3,7,8,2,6,D1,338
D,Colombia,3,7,7,2,5,D2,338
D,Costa Rica,3,3,3,6,-3,D3,338
D,Paraguay,3,0,3,11,-8,D4,338
A,Chile,3,7,6,1,5,A1,339
A,Argentina,3,7,3,0,3,A2,339
A,Peru,3,3,4,5,-1,A3,339
A,Canada,3,0,1,8,-7,A4,339
B,Ecuador,3,7,9,4,5,B1,339
B,Venezuela,3,6,10,6,4,B2,339
B,Jamaica,3,3,1,7,-6,B3,339
B,Mexico,3,1,4,7,-3,B4,339
C,Uruguay,3,7,8,1,7,C1,339
C,United States,3,7,6,1,5,C2,339
C,Bolivia,3,3,2,6,-4,C3,339
C,Panama,3,0,0,8,-8,C4,339
D,Colombia,3,6,7,2,5,D1,339
D,Brazil,3,6,6,1,5,D2,339
D,Costa Rica,3,6,3,5,-2,D3,339
D,Paraguay,3,0,1,9,-8,D4,339
A,Argentina,3,6,6,2,4,A1,340
A,Chile,3,6,5,2,3,A2,340
A,Peru,3,6,3,3,0,A3,340
A,Canada,3,0,0,7,-7,A4,340
B,Venezuela,3,5,4,2,2,B1,340
B,Jamaica,3,5,3,1,2,B2,340
B,Mexico,3,3,2,2,0,B3,340
B,Ecuador,3,1,1,5,-4,B4,340
C,United States,3,7,7,1,6,C1,340
C,Uruguay,3,6,8,5,3,C2,340
C,Panama,3,3,2,8,-6,C3,340
C,Bolivia,3,1,0,3,-3,C4,340
D,Brazil,3,6,7,2,5,D1,340
D,Colombia,3,6,4,1,3,D2,340
D,Costa Rica,3,6,3,4,-1,D3,340
D,Paraguay,3,0,0,7,-7,D4,340
A,Argentina,3,6,5,3,2,A1,341
A,Canada,3,4,2,2,0,A2,341
A,Chile,3,4,2,2,0,A3,341
A,Peru,3,3,2,4,-2,A4,341
B,Mexico,3,9,8,1,7,B1,341
B,Venezuela,3,6,7,5,2,B2,341
B,Ecuador,3,3,3,3,0,B3,341
B,Jamaica,3,0,1,10,-9,B4,341
C,Uruguay,3,9,4,1,3,C1,341
C,United States,3,6,4,2,2,C2,341
C,Panama,3,3,2,4,-2,C3,341
C,Bolivia,3,0,3,6,-3,C4,341
D,Brazil,3,7,3,0,3,D1,341
D,Costa Rica,3,4,2,1,1,D2,341
D,Colombia,3,3,0,0,0,D3,341
D,Paraguay,3,1,0,4,-4,D4,341
A,Argentina,3,7,7,1,6,A1,342
A,Chile,3,5,6,2,4,A2,342
A,Canada,3,2,2,5,-3,A3,342
A,Peru,3,1,1,8,-7,A4,342
B,Ecuador,3,9,7,3,4,B1,342
B,Mexico,3,6,7,2,5,B2,342
B,Jamaica,3,1,2,6,-4,B3,342
B,Venezuela,3,1,2,7,-5,B4,342
C,Uruguay,3,9,6,1,5,C1,342
C,United States,3,6,2,3,-1,C2,342
C,Bolivia,3,3,4,5,-1,C3,342
C,Panama,3,0,4,7,-3,C4,342
D,Brazil,3,9,6,1,5,D1,342
D,Colombia,3,4,3,3,0,D2,342
D,Paraguay,3,4,1,1,0,D3,342
D,Costa Rica,3,0,1,6,-5,D4,342
A,Peru,3,7,7,2,5,A1,343
A,Chile,3,6,4,5,-1,A2,343
A,Canada,3,4,4,3,1,A3,343
A,Argentina,3,0,0,5,-5,A4,343
B,Mexico,3,9,8,1,7,B1,343
B,Ecuador,3,6,3,2,1,B2,343
B,Venezuela,3,3,3,5,-2,B3,343
B,Jamaica,3,0,2,8,-6,B4,343
C,Uruguay,3,9,7,1,6,C1,343
C,United States,3,4,4,4,0,C2,343
C,Panama,3,3,3,5,-2,C3,343
C,Bolivia,3,1,0,4,-4,C4,343
D,Brazil,3,5,3,1,2,D1,343
D,Costa Rica,3,5,3,1,2,D2,343
D,Colombia,3,4,1,2,-1,D3,343
D,Paraguay,3,1,0,3,-3,D4,343
A,Canada,3,7,4,1,3,A1,344
A,Argentina,3,6,4,2,2,A2,344
A,Peru,3,2,2,3,-1,A3,344
A,Chile,3,1,0,4,-4,A4,344
B,Ecuador,3,7,6,4,2,B1,344
B,Jamaica,3,4,5,5,0,B2,344
B,Mexico,3,4,4,4,0,B3,344
B,Venezuela,3,1,1,3,-2,B4,344
C,Uruguay,3,6,4,3,1,C1,344
C,United States,3,5,5,3,2,C2,344
C,Panama,3,4,5,5,0,C3,344
C,Bolivia,3,1,2,5,-3,C4,344
D,Colombia,3,9,6,1,5,D1,344
D,Brazil,3,6,6,1,5,D2,344
D,Paraguay,3,3,3,5,-2,D3,344
D,Costa Rica,3,0,1,9,-8,D4,344
A,Argentina,3,3,5,5,0,A1,345
A,Chile,3,3,5,5,0,A2,345
A,Canada,3,3,4,4,0,A3,345
A,Peru,3,3,4,4,0,A4,345
B,Mexico,3,7,5,3,2,B1,345
B,Jamaica,3,6,4,2,2,B2,345
B,Ecuador,3,2,3,5,-2,B3,345
B,Venezuela,3,1,3,5,-2,B4,345
C,United States,3,7,7,2,5,C1,345
C,Uruguay,3,7,4,1,3,C2,345
C,Bolivia,3,1,3,5,-2,C3,345
C,Panama,3,1,2,8,-6,C4,345
D,Brazil,3,7,7,3,4,D1,345
D,Paraguay,3,4,6,7,-1,D2,345
D,Costa Rica,3,3,2,4,-2,D3,345
D,Colombia,3,2,2,3,-1,D4,345
A,Argentina,3,9,7,2,5,A1,346
A,Canada,3,6,5,3,2,A2,346
A,Chile,3,3,2,4,-2,A3,346
A,Peru,3,0,1,6,-5,A4,346
B,Mexico,3,9,6,1,5,B1,346
B,Ecuador,3,4,2,2,0,B2,346
B,Jamaica,3,3,1,2,-1,B3,346
B,Venezuela,3,1,0,4,-4,B4,346
C,United States,3,6,8,2,6,C1,346
C,Uruguay,3,6,4,2,2,C2,346
C,Bolivia,3,6,2,3,-1,C3,346
C,Panama,3,0,0,7,-7,C4,346
D,Paraguay,3,7,2,0,2,D1,346
D,Brazil,3,6,5,1,4,D2,346
D,Costa Rica,3,2,1,5,-4,D3,346
D,Colombia,3,1,1,3,-2,D4,346
A,Canada,3,7,5,2,3,A1,347
A,Chile,3,6,5,2,3,A2,347
A,Peru,3,2,1,2,-1,A3,347
A,Argentina,3,1,2,7,-5,A4,347
B,Mexico,3,9,8,2,6,B1,347
B,Jamaica,3,4,4,5,-1,B2,347
B,Venezuela,3,3,3,5,-2,B3,347
B,Ecuador,3,1,3,6,-3,B4,347
C,Uruguay,3,9,13,2,11,C1,347
C,United States,3,6,3,3,0,C2,347
C,Panama,3,1,5,8,-3,C3,347
C,Bolivia,3,1,3,11,-8,C4,347
D,Brazil,3,7,7,5,2,D1,347
D,Costa Rica,3,5,6,5,1,D2,347
D,Paraguay,3,3,5,4,1,D3,347
D,Colombia,3,1,4,8,-4,D4,347
A,Argentina,3,6,5,2,3,A1,348
A,Canada,3,6,4,5,-1,A2,348
A,Chile,3,4,4,4,0,A3,348
A,Peru,3,1,4,6,-2,A4,348
B,Mexico,3,6,3,2,1,B1,348
B,Venezuela,3,4,3,3,0,B2,348
B,Jamaica,3,4,1,1,0,B3,348
B,Ecuador,3,2,3,4,-1,B4,348
C,Uruguay,3,9,5,0,5,C1,348
C,United States,3,6,7,3,4,C2,348
C,Bolivia,3,1,1,4,-3,C3,348
C,Panama,3,1,2,8,-6,C4,348
D,Brazil,3,7,8,4,4,D1,348
D,Colombia,3,6,7,3,4,D2,348
D,Costa Rica,3,3,2,7,-5,D3,348
D,Paraguay,3,1,1,4,-3,D4,348
A,Argentina,3,9,6,3,3,A1,349
A,Peru,3,6,4,2,2,A2,349
A,Canada,3,1,3,5,-2,A3,349
A,Chile,3,1,1,4,-3,A4,349
B,Mexico,3,5,8,2,6,B1,349
B,Venezuela,3,5,6,5,1,B2,349
B,Ecuador,3,4,5,8,-3,B3,349
B,Jamaica,3,1,5,9,-4,B4,349
C,United States,3,7,4,1,3,C1,349
C,Uruguay,3,6,6,2,4,C2,349
C,Panama,3,4,4,4,0,C3,349
C,Bolivia,3,0,2,9,-7,C4,349
D,Brazil,3,7,7,3,4,D1,349
D,Costa Rica,3,4,3,2,1,D2,349
D,Colombia,3,2,1,3,-2,D3,349
D,Paraguay,3,2,1,4,-3,D4,349
A,Argentina,3,7,6,2,4,A1,350
A,Canada,3,3,3,3,0,A2,350
A,Peru,3,2,2,3,-1,A3,350
A,Chile,3,2,1,4,-3,A4,350
B,Ecuador,3,7,6,2,4,B1,350
B,Jamaica,3,6,8,3,5,B2,350
B,Venezuela,3,2,3,9,-6,B3,350
B,Mexico,3,1,0,3,-3,B4,350
C,Uruguay,3,4,4,3,1,C1,350
C,United States,3,4,2,2,0,C2,350
C,Bolivia,3,4,3,4,-1,C3,350
C,Panama,3,3,3,3,0,C4,350
D,Brazil,3,9,7,1,6,D1,350
D,Costa Rica,3,4,3,3,0,D2,350
D,Colombia,3,4,1,1,0,D3,350
D,Paraguay,3,0,1,7,-6,D4,350
A,Chile,3,7,6,3,3,A1,351
A,Canada,3,6,5,3,2,A2,351
A,Argentina,3,4,6,5,1,A3,351
A,Peru,3,0,1,7,-6,A4,351
B,Ecuador,3,7,5,2,3,B1,351
B,Venezuela,3,4,4,4,0,B2,351
B,Jamaica,3,3,3,3,0,B3,351
B,Mexico,3,1,1,4,-3,B4,351
C,Uruguay,3,7,5,2,3,C1,351
C,United States,3,5,5,3,2,C2,351
C,Panama,3,4,4,3,1,C3,351
C,Bolivia,3,0,1,7,-6,C4,351
D,Brazil,3,6,3,1,2,D1,351
D,Paraguay,3,5,1,0,1,D2,351
D,Colombia,3,4,1,1,0,D3,351
D,Costa Rica,3,1,0,3,-3,D4,351
A,Argentina,3,7,5,2,3,A1,352
A,Canada,3,6,4,3,1,A2,352
A,Chile,3,4,3,3,0,A3,352
A,Peru,3,0,2,6,-4,A4,352
B,Mexico,3,7,4,2,2,B1,352
B,Venezuela,3,4,3,3,0,B2,352
B,Jamaica,3,3,2,3,-1,B3,352
B,Ecuador,3,2,3,4,-1,B4,352
C,Uruguay,3,5,6,4,2,C1,352
C,United States,3,5,4,2,2,C2,352
C,Panama,3,3,2,5,-3,C3,352
C,Bolivia,3,2,5,6,-1,C4,352
D,Colombia,3,7,8,1,7,D1,352
D,Brazil,3,5,4,2,2,D2,352
D,Costa Rica,3,3,3,7,-4,D3,352
D,Paraguay,3,1,2,7,-5,D4,352
A,Canada,3,7,5,2,3,A1,353
A,Argentina,3,6,7,4,3,A2,353
A,Chile,3,4,5,5,0,A3,353
A,Peru,3,0,1,7,-6,A4,353
B,Ecuador,3,7,5,2,3,B1,353
B,Venezuela,3,4,4,3,1,B2,353
B,Mexico,3,4,3,3,0,B3,353
B,Jamaica,3,1,3,7,-4,B4,353
C,United States,3,5,3,1,2,C1,353
C,Uruguay,3,4,5,3,2,C2,353
C,Panama,3,4,1,4,-3,C3,353
C,Bolivia,3,2,2,3,-1,C4,353
D,Brazil,3,9,8,0,8,D1,353
D,Costa Rica,3,4,2,4,-2,D2,353
D,Paraguay,3,3,2,6,-4,D3,353
D,Colombia,3,1,1,3,-2,D4,353
A,Chile,3,6,6,3,3,A1,354
A,Argentina,3,4,3,3,0,A2,354
A,Canada,3,4,4,5,-1,A3,354
A,Peru,3,3,5,7,-2,A4,354
B,Mexico,3,7,5,2,3,B1,354
B,Ecuador,3,6,4,2,2,B2,354
B,Venezuela,3,3,5,5,0,B3,354
B,Jamaica,3,1,0,5,-5,B4,354
C,Uruguay,3,9,4,1,3,C1,354
C,Panama,3,6,2,1,1,C2,354
C,Bolivia,3,3,2,3,-1,C3,354
C,United States,3,0,0,3,-3,C4,354
D,Brazil,3,5,6,5,1,D1,354
D,Paraguay,3,4,5,5,0,D2,354
D,Colombia,3,4,4,4,0,D3,354
D,Costa Rica,3,3,3,4,-1,D4,354
A,Peru,3,7,3,0,3,A1,355
A,Argentina,3,6,4,2,2,A2,355
A,Canada,3,4,1,1,0,A3,355
A,Chile,3,0,1,6,-5,A4,355
B,Ecuador,3,9,5,1,4,B1,355
B,Venezuela,3,6,5,3,2,B2,355
B,Mexico,3,3,3,3,0,B3,355
B,Jamaica,3,0,0,6,-6,B4,355
C,United States,3,6,4,1,3,C1,355
C,Panama,3,4,2,2,0,C2,355
C,Uruguay,3,4,1,2,-1,C3,355
C,Bolivia,3,2,1,3,-2,C4,355
D,Brazil,3,7,6,3,3,D1,355
D,Colombia,3,4,3,2,1,D2,355
D,Costa Rica,3,3,4,7,-3,D3,355
D,Paraguay,3,2,3,4,-1,D4,355
A,Peru,3,6,3,5,-2,A1,356
A,Canada,3,4,8,6,2,A2,356
A,Argentina,3,4,4,3,1,A3,356
A,Chile,3,2,3,4,-1,A4,356
B,Mexico,3,7,6,2,4,B1,356
B,Ecuador,3,4,6,5,1,B2,356
B,Jamaica,3,3,3,3,0,B3,356
B,Venezuela,3,1,1,6,-5,B4,356
C,United States,3,7,6,1,5,C1,356
C,Uruguay,3,6,4,2,2,C2,356
C,Bolivia,3,3,3,6,-3,C3,356
C,Panama,3,1,1,5,-4,C4,356
D,Brazil,3,6,5,1,4,D1,356
D,Costa Rica,3,6,3,2,1,D2,356
D,Colombia,3,4,3,5,-2,D3,356
D,Paraguay,3,1,3,6,-3,D4,356
A,Argentina,3,7,9,1,8,A1,357
A,Peru,3,4,2,4,-2,A2,357
A,Canada,3,3,5,7,-2,A3,357
A,Chile,3,3,1,5,-4,A4,357
B,Mexico,3,7,7,0,7,B1,357
B,Ecuador,3,4,1,1,0,B2,357
B,Venezuela,3,3,1,4,-3,B3,357
B,Jamaica,3,3,1,5,-4,B4,357
C,Uruguay,3,7,12,2,10,C1,357
C,Bolivia,3,4,6,6,0,C2,357
C,United States,3,3,3,4,-1,C3,357
C,Panama,3,3,3,12,-9,C4,357
D,Colombia,3,7,3,1,2,D1,357
D,Brazil,3,4,2,1,1,D2,357
D,Paraguay,3,4,2,2,0,D3,357
D,Costa Rica,3,1,0,3,-3,D4,357
A,Argentina,3,9,6,0,6,A1,358
A,Peru,3,4,2,1,1,A2,358
A,Canada,3,2,2,5,-3,A3,358
A,Chile,3,1,2,6,-4,A4,358
B,Ecuador,3,6,6,2,4,B1,358
B,Venezuela,3,6,5,1,4,B2,358
B,Mexico,3,4,2,3,-1,B3,358
B,Jamaica,3,1,0,7,-7,B4,358
C,United States,3,9,7,2,5,C1,358
C,Uruguay,3,6,9,4,5,C2,358
C,Panama,3,3,3,6,-3,C3,358
C,Bolivia,3,0,1,8,-7,C4,358
D,Colombia,3,5,3,2,1,D1,358
D,Paraguay,3,5,1,0,1,D2,358
D,Brazil,3,4,3,3,0,D3,358
D,Costa Rica,3,1,2,4,-2,D4,358
A,Argentina,3,9,10,2,8,A1,359
A,Chile,3,6,3,4,-1,A2,359
A,Canada,3,1,1,4,-3,A3,359
A,Peru,3,1,1,5,-4,A4,359
B,Mexico,3,7,7,4,3,B1,359
B,Venezuela,3,6,5,2,3,B2,359
B,Ecuador,3,4,4,5,-1,B3,359
B,Jamaica,3,0,2,7,-5,B4,359
C,United States,3,9,12,4,8,C1,359
C,Panama,3,3,1,2,-1,C2,359
C,Bolivia,3,3,5,7,-2,C3,359
C,Uruguay,3,3,1,6,-5,C4,359
D,Brazil,3,9,11,0,11,D1,359
D,Paraguay,3,4,1,3,-2,D2,359
D,Colombia,3,2,1,6,-5,D3,359
D,Costa Rica,3,1,1,5,-4,D4,359
A,Argentina,3,9,5,0,5,A1,360
A,Peru,3,6,3,2,1,A2,360
A,Chile,3,3,3,4,-1,A3,360
A,Canada,3,0,1,6,-5,A4,360
B,Ecuador,3,7,3,1,2,B1,360
B,Venezuela,3,4,2,1,1,B2,360
B,Jamaica,3,4,2,3,-1,B3,360
B,Mexico,3,1,0,2,-2,B4,360
C,Uruguay,3,7,5,3,2,C1,360
C,United States,3,5,3,1,2,C2,360
C,Panama,3,4,4,4,0,C3,360
C,Bolivia,3,0,3,7,-4,C4,360
D,Brazil,3,9,6,0,6,D1,360
D,Colombia,3,6,3,2,1,D2,360
D,Costa Rica,3,1,2,5,-3,D3,360
D,Paraguay,3,1,1,5,-4,D4,360
A,Peru,3,5,2,1,1,A1,361
A,Canada,3,4,5,5,0,A2,361
A,Argentina,3,4,3,3,0,A3,361
A,Chile,3,2,1,2,-1,A4,361
B,Venezuela,3,9,6,2,4,B1,361
B,Ecuador,3,6,5,3,2,B2,361
B,Mexico,3,3,3,3,0,B3,361
B,Jamaica,3,0,0,6,-6,B4,361
C,United States,3,9,4,1,3,C1,361
C,Uruguay,3,6,5,1,4,C2,361
C,Bolivia,3,3,1,3,-2,C3,361
C,Panama,3,0,1,6,-5,C4,361
D,Brazil,3,7,8,1,7,D1,361
D,Colombia,3,7,5,2,3,D2,361
D,Paraguay,3,3,2,4,-2,D3,361
D,Costa Rica,3,0,0,8,-8,D4,361
A,Argentina,3,7,9,2,7,A1,362
A,Peru,3,6,2,5,-3,A2,362
A,Canada,3,3,1,3,-2,A3,362
A,Chile,3,1,2,4,-2,A4,362
B,Venezuela,3,7,3,1,2,B1,362
B,Mexico,3,6,3,1,2,B2,362
B,Jamaica,3,3,1,3,-2,B3,362
B,Ecuador,3,1,1,3,-2,B4,362
C,Uruguay,3,9,6,0,6,C1,362
C,United States,3,4,6,4,2,C2,362
C,Panama,3,4,4,6,-2,C3,362
C,Bolivia,3,0,1,7,-6,C4,362
D,Brazil,3,9,7,0,7,D1,362
D,Paraguay,3,4,3,3,0,D2,362
D,Colombia,3,2,1,4,-3,D3,362
D,Costa Rica,3,1,2,6,-4,D4,362
A,Argentina,3,5,4,2,2,A1,363
A,Canada,3,3,5,5,0,A2,363
A,Peru,3,3,3,3,0,A3,363
A,Chile,3,2,2,4,-2,A4,363
B,Mexico,3,7,5,1,4,B1,363
B,Venezuela,3,6,5,1,4,B2,363
B,Ecuador,3,4,3,2,1,B3,363
B,Jamaica,3,0,0,9,-9,B4,363
C,United States,3,7,7,3,4,C1,363
C,Panama,3,4,3,3,0,C2,363
C,Uruguay,3,3,4,5,-1,C3,363
C,Bolivia,3,3,3,6,-3,C4,363
D,Brazil,3,7,7,3,4,D1,363
D,Colombia,3,5,2,1,1,D2,363
D,Paraguay,3,4,1,2,-1,D3,363
D,Costa Rica,3,0,2,6,-4,D4,363
A,Peru,3,7,5,1,4,A1,364
A,Argentina,3,4,4,4,0,A2,364
A,Chile,3,2,3,5,-2,A3,364
A,Canada,3,2,0,2,-2,A4,364
B,Jamaica,3,5,4,1,3,B1,364
B,Ecuador,3,4,3,2,1,B2,364
B,Mexico,3,4,2,2,0,B3,364
B,Venezuela,3,3,2,6,-4,B4,364
C,Bolivia,3,7,5,3,2,C1,364
C,United States,3,4,5,4,1,C2,364
C,Panama,3,2,4,5,-1,C3,364
C,Uruguay,3,2,2,4,-2,C4,364
D,Brazil,3,9,7,2,5,D1,364
D,Colombia,3,6,6,2,4,D2,364
D,Paraguay,3,3,2,5,-3,D3,364
D,Costa Rica,3,0,0,6,-6,D4,364
A,Argentina,3,9,10,1,9,A1,365
A,Chile,3,4,5,2,3,A2,365
A,Peru,3,2,2,5,-3,A3,365
A,Canada,3,1,2,11,-9,A4,365
B,Venezuela,3,7,5,3,2,B1,365
B,Jamaica,3,4,5,2,3,B2,365
B,Mexico,3,3,3,3,0,B3,365
B,Ecuador,3,1,3,8,-5,B4,365
C,United States,3,5,3,2,1,C1,365
C,Uruguay,3,4,5,4,1,C2,365
C,Panama,3,4,4,3,1,C3,365
C,Bolivia,3,3,3,6,-3,C4,365
D,Brazil,3,6,6,2,4,D1,365
D,Costa Rica,3,6,4,3,1,D2,365
D,Colombia,3,3,1,2,-1,D3,365
D,Paraguay,3,3,3,7,-4,D4,365
A,Argentina,3,9,10,0,10,A1,366
A,Peru,3,6,6,6,0,A2,366
A,Chile,3,3,5,6,-1,A3,366
A,Canada,3,0,3,12,-9,A4,366
B,Mexico,3,9,9,3,6,B1,366
B,Ecuador,3,6,4,5,-1,B2,366
B,Venezuela,3,3,2,3,-1,B3,366
B,Jamaica,3,0,0,4,-4,B4,366
C,Uruguay,3,9,9,2,7,C1,366
C,Bolivia,3,4,1,4,-3,C2,366
C,United States,3,2,1,3,-2,C3,366
C,Panama,3,1,3,5,-2,C4,366
D,Brazil,3,9,7,0,7,D1,366
D,Colombia,3,4,2,2,0,D2,366
D,Costa Rica,3,2,0,4,-4,D3,366
D,Paraguay,3,1,0,3,-3,D4,366
A,Peru,3,9,4,0,4,A1,367
A,Chile,3,4,3,2,1,A2,367
A,Argentina,3,4,3,4,-1,A3,367
A,Canada,3,0,1,5,-4,A4,367
B,Mexico,3,7,6,3,3,B1,367
B,Ecuador,3,6,8,2,6,B2,367
B,Venezuela,3,4,4,3,1,B3,367
B,Jamaica,3,0,0,10,-10,B4,367
C,United States,3,7,7,2,5,C1,367
C,Uruguay,3,4,6,3,3,C2,367
C,Panama,3,4,4,7,-3,C3,367
C,Bolivia,3,1,3,8,-5,C4,367
D,Brazil,3,6,7,3,4,D1,367
D,Paraguay,3,6,2,1,1,D2,367
D,Colombia,3,4,3,5,-2,D3,367
D,Costa Rica,3,1,2,5,-3,D4,367
A,Argentina,3,7,7,3,4,A1,368
A,Peru,3,6,5,5,0,A2,368
A,Canada,3,3,3,4,-1,A3,368
A,Chile,3,1,3,6,-3,A4,368
B,Mexico,3,9,4,1,3,B1,368
B,Jamaica,3,4,1,1,0,B2,368
B,Ecuador,3,2,2,3,-1,B3,368
B,Venezuela,3,1,1,3,-2,B4,368
C,United States,3,7,7,3,4,C1,368
C,Uruguay,3,7,4,1,3,C2,368
C,Panama,3,3,3,4,-1,C3,368
C,Bolivia,3,0,2,8,-6,C4,368
D,Costa Rica,3,5,2,1,1,D1,368
D,Colombia,3,4,2,2,0,D2,368
D,Brazil,3,3,2,2,0,D3,368
D,Paraguay,3,2,2,3,-1,D4,368
A,Argentina,3,9,7,1,6,A1,369
A,Canada,3,4,3,3,0,A2,369
A,Chile,3,2,2,4,-2,A3,369
A,Peru,3,1,2,6,-4,A4,369
B,Mexico,3,5,3,2,1,B1,369
B,Venezuela,3,5,3,2,1,B2,369
B,Jamaica,3,3,2,3,-1,B3,369
B,Ecuador,3,2,1,2,-1,B4,369
C,United States,3,9,7,1,6,C1,369
C,Panama,3,6,7,7,0,C2,369
C,Bolivia,3,3,6,7,-1,C3,369
C,Uruguay,3,0,2,7,-5,C4,369
D,Brazil,3,9,8,0,8,D1,369
D,Costa Rica,3,6,2,2,0,D2,369
D,Colombia,3,1,3,6,-3,D3,369
D,Paraguay,3,1,3,8,-5,D4,369
A,Chile,3,7,4,0,4,A1,370
A,Peru,3,4,1,2,-1,A2,370
A,Argentina,3,3,3,3,0,A3,370
A,Canada,3,3,2,5,-3,A4,370
B,Ecuador,3,7,10,2,8,B1,370
B,Mexico,3,5,3,2,1,B2,370
B,Venezuela,3,2,0,4,-4,B3,370
B,Jamaica,3,1,2,7,-5,B4,370
C,Uruguay,3,7,7,2,5,C1,370
C,United States,3,6,5,3,2,C2,370
C,Bolivia,3,3,4,9,-5,C3,370
C,Panama,3,1,2,4,-2,C4,370
D,Brazil,3,6,6,2,4,D1,370
D,Costa Rica,3,5,3,2,1,D2,370
D,Colombia,3,4,3,5,-2,D3,370
D,Paraguay,3,1,1,4,-3,D4,370
A,Argentina,3,7,5,0,5,A1,371
A,Chile,3,4,2,2,0,A2,371
A,Peru,3,4,1,3,-2,A3,371
A,Canada,3,1,1,4,-3,A4,371
B,Mexico,3,6,5,3,2,B1,371
B,Venezuela,3,6,4,4,0,B2,371
B,Ecuador,3,3,5,5,0,B3,371
B,Jamaica,3,3,2,4,-2,B4,371
C,United States,3,4,5,1,4,C1,371
C,Panama,3,4,1,1,0,C2,371
C,Bolivia,3,4,2,6,-4,C3,371
C,Uruguay,3,3,1,1,0,C4,371
D,Brazil,3,5,5,2,3,D1,371
D,Paraguay,3,5,5,4,1,D2,371
D,Costa Rica,3,4,4,5,-1,D3,371
D,Colombia,3,1,2,5,-3,D4,371
A,Peru,3,6,4,3,1,A1,372
A,Argentina,3,6,3,2,1,A2,372
A,Chile,3,6,3,2,1,A3,372
A,Canada,3,0,2,5,-3,A4,372
B,Ecuador,3,5,4,1,3,B1,372
B,Mexico,3,5,2,0,2,B2,372
B,Jamaica,3,2,2,4,-2,B3,372
B,Venezuela,3,2,1,4,-3,B4,372
C,Uruguay,3,9,11,1,10,C1,372
C,United States,3,3,1,3,-2,C2,372
C,Bolivia,3,3,3,6,-3,C3,372
C,Panama,3,3,2,7,-5,C4,372
D,Brazil,3,9,10,2,8,D1,372
D,Colombia,3,4,5,5,0,D2,372
D,Costa Rica,3,3,3,7,-4,D3,372
D,Paraguay,3,1,3,7,-4,D4,372
A,Chile,3,6,4,4,0,A1,373
A,Argentina,3,4,5,3,2,A2,373
A,Canada,3,4,3,3,0,A3,373
A,Peru,3,3,2,4,-2,A4,373
B,Mexico,3,9,5,1,4,B1,373
B,Ecuador,3,6,7,2,5,B2,373
B,Venezuela,3,1,1,3,-2,B3,373
B,Jamaica,3,1,1,8,-7,B4,373
C,United States,3,7,7,2,5,C1,373
C,Uruguay,3,4,2,2,0,C2,373
C,Panama,3,3,3,5,-2,C3,373
C,Bolivia,3,3,2,5,-3,C4,373
D,Brazil,3,9,6,0,6,D1,373
D,Paraguay,3,2,5,6,-1,D2,373
D,Colombia,3,2,3,4,-1,D3,373
D,Costa Rica,3,2,4,8,-4,D4,373
A,Argentina,3,6,7,2,5,A1,374
A,Peru,3,5,4,3,1,A2,374
A,Chile,3,4,3,2,1,A3,374
A,Canada,3,1,3,10,-7,A4,374
B,Mexico,3,7,9,1,8,B1,374
B,Ecuador,3,7,3,1,2,B2,374
B,Venezuela,3,3,3,2,1,B3,374
B,Jamaica,3,0,0,11,-11,B4,374
C,Uruguay,3,6,6,4,2,C1,374
C,United States,3,5,3,1,2,C2,374
C,Bolivia,3,4,3,2,1,C3,374
C,Panama,3,1,0,5,-5,C4,374
D,Brazil,3,9,4,1,3,D1,374
D,Colombia,3,3,3,2,1,D2,374
D,Costa Rica,3,3,2,3,-1,D3,374
D,Paraguay,3,3,1,4,-3,D4,374
A,Argentina,3,9,7,2,5,A1,375
A,Chile,3,4,3,2,1,A2,375
A,Peru,3,4,3,2,1,A3,375
A,Canada,3,0,1,8,-7,A4,375
B,Venezuela,3,7,8,3,5,B1,375
B,Mexico,3,7,4,2,2,B2,375
B,Ecuador,3,1,0,3,-3,B3,375
B,Jamaica,3,1,1,5,-4,B4,375
C,Uruguay,3,9,10,3,7,C1,375
C,United States,3,6,7,5,2,C2,375
C,Panama,3,1,3,6,-3,C3,375
C,Bolivia,3,1,3,9,-6,C4,375
D,Brazil,3,9,7,2,5,D1,375
D,Colombia,3,4,1,1,0,D2,375
D,Costa Rica,3,4,2,4,-2,D3,375
D,Paraguay,3,0,1,4,-3,D4,375
A,Chile,3,6,3,4,-1,A1,376
A,Canada,3,4,3,3,0,A2,376
A,Peru,3,4,6,7,-1,A3,376
A,Argentina,3,3,4,2,2,A4,376
B,Ecuador,3,5,3,1,2,B1,376
B,Venezuela,3,5,2,0,2,B2,376
B,Mexico,3,5,3,2,1,B3,376
B,Jamaica,3,0,1,6,-5,B4,376
C,Bolivia,3,6,2,5,-3,C1,376
C,Panama,3,4,5,4,1,C2,376
C,United States,3,4,2,1,1,C3,376
C,Uruguay,3,3,4,3,1,C4,376
D,Brazil,3,7,6,1,5,D1,376
D,Colombia,3,4,3,3,0,D2,376
D,Costa Rica,3,4,2,5,-3,D3,376
D,Paraguay,3,1,2,4,-2,D4,376
A,Argentina,3,9,9,3,6,A1,377
A,Chile,3,4,4,7,-3,A2,377
A,Peru,3,3,6,5,1,A3,377
A,Canada,3,1,3,7,-4,A4,377
B,Mexico,3,7,6,3,3,B1,377
B,Ecuador,3,4,3,2,1,B2,377
B,Jamaica,3,3,4,5,-1,B3,377
B,Venezuela,3,2,1,4,-3,B4,377
C,Uruguay,3,9,7,0,7,C1,377
C,United States,3,4,1,1,0,C2,377
C,Panama,3,4,2,3,-1,C3,377
C,Bolivia,3,0,0,6,-6,C4,377
D,Brazil,3,7,4,1,3,D1,377
D,Colombia,3,4,4,3,1,D2,377
D,Costa Rica,3,3,3,5,-2,D3,377
D,Paraguay,3,3,2,4,-2,D4,377
A,Argentina,3,7,4,1,3,A1,378
A,Canada,3,7,2,0,2,A2,378
A,Chile,3,3,4,5,-1,A3,378
A,Peru,3,0,2,6,-4,A4,378
B,Ecuador,3,9,6,1,5,B1,378
B,Mexico,3,3,4,4,0,B2,378
B,Jamaica,3,3,3,5,-2,B3,378
B,Venezuela,3,3,3,6,-3,B4,378
C,United States,3,9,7,1,6,C1,378
C,Uruguay,3,6,4,3,1,C2,378
C,Panama,3,3,3,6,-3,C3,378
C,Bolivia,3,0,1,5,-4,C4,378
D,Brazil,3,9,7,1,6,D1,378
D,Paraguay,3,4,3,3,0,D2,378
D,Costa Rica,3,3,2,4,-2,D3,378
D,Colombia,3,1,2,6,-4,D4,378
A,Argentina,3,7,4,0,4,A1,379
A,Chile,3,6,2,1,1,A2,379
A,Canada,3,3,1,4,-3,A3,379
A,Peru,3,1,0,2,-2,A4,379
B,Mexico,3,7,5,1,4,B1,379
B,Jamaica,3,4,2,3,-1,B2,379
B,Ecuador,3,2,3,4,-1,B3,379
B,Venezuela,3,2,1,3,-2,B4,379
C,Uruguay,3,9,10,5,5,C1,379
C,United States,3,6,8,6,2,C2,379
C,Panama,3,3,4,6,-2,C3,379
C,Bolivia,3,0,3,8,-5,C4,379
D,Colombia,3,7,6,1,5,D1,379
D,Brazil,3,4,4,3,1,D2,379
D,Costa Rica,3,3,2,5,-3,D3,379
D,Paraguay,3,3,1,4,-3,D4,379
A,Canada,3,5,7,4,3,A1,380
A,Peru,3,4,2,4,-2,A2,380
A,Argentina,3,3,3,3,0,A3,380
A,Chile,3,2,6,7,-1,A4,380
B,Mexico,3,7,6,2,4,B1,380
B,Ecuador,3,5,5,3,2,B2,380
B,Venezuela,3,2,2,4,-2,B3,380
B,Jamaica,3,1,3,7,-4,B4,380
C,United States,3,7,5,2,3,C1,380
C,Uruguay,3,5,6,3,3,C2,380
C,Bolivia,3,3,4,8,-4,C3,380
C,Panama,3,1,4,6,-2,C4,380
D,Colombia,3,9,8,1,7,D1,380
D,Brazil,3,6,5,3,2,D2,380
D,Paraguay,3,1,1,5,-4,D3,380
D,Costa Rica,3,1,2,7,-5,D4,380
A,Argentina,3,7,5,1,4,A1,381
A,Chile,3,5,4,1,3,A2,381
A,Peru,3,4,3,2,1,A3,381
A,Canada,3,0,1,9,-8,A4,381
B,Mexico,3,7,4,1,3,B1,381
B,Venezuela,3,4,4,4,0,B2,381
B,Ecuador,3,3,2,3,-1,B3,381
B,Jamaica,3,3,2,4,-2,B4,381
C,Uruguay,3,7,2,0,2,C1,381
C,United States,3,6,4,1,3,C2,381
C,Bolivia,3,3,2,3,-1,C3,381
C,Panama,3,1,0,4,-4,C4,381
D,Brazil,3,7,6,0,6,D1,381
D,Colombia,3,6,6,6,0,D2,381
D,Paraguay,3,4,2,2,0,D3,381
D,Costa Rica,3,0,0,6,-6,D4,381
A,Argentina,3,9,10,3,7,A1,382
A,Peru,3,6,5,5,0,A2,382
A,Chile,3,3,4,4,0,A3,382
A,Canada,3,0,2,9,-7,A4,382
B,Venezuela,3,5,4,2,2,B1,382
B,Ecuador,3,4,2,1,1,B2,382
B,Jamaica,3,4,2,2,0,B3,382
B,Mexico,3,3,2,5,-3,B4,382
C,United States,3,9,8,1,7,C1,382
C,Uruguay,3,6,5,2,3,C2,382
C,Panama,3,3,1,6,-5,C3,382
C,Bolivia,3,0,0,5,-5,C4,382
D,Brazil,3,9,8,1,7,D1,382
D,Colombia,3,6,5,4,1,D2,382
D,Costa Rica,3,1,2,6,-4,D3,382
D,Paraguay,3,1,1,5,-4,D4,382
A,Argentina,3,7,6,4,2,A1,383
A,Chile,3,4,6,6,0,A2,383
A,Canada,3,3,3,3,0,A3,383
A,Peru,3,3,4,6,-2,A4,383
B,Mexico,3,5,6,3,3,B1,383
B,Ecuador,3,5,2,1,1,B2,383
B,Venezuela,3,3,3,3,0,B3,383
B,Jamaica,3,1,1,5,-4,B4,383
C,Uruguay,3,7,7,1,6,C1,383
C,United States,3,7,4,0,4,C2,383
C,Panama,3,3,2,5,-3,C3,383
C,Bolivia,3,0,0,7,-7,C4,383
D,Colombia,3,7,4,2,2,D1,383
D,Brazil,3,6,5,2,3,D2,383
D,Costa Rica,3,3,1,2,-1,D3,383
D,Paraguay,3,1,1,5,-4,D4,383
A,Argentina,3,9,8,3,5,A1,384
A,Chile,3,4,1,2,-1,A2,384
A,Peru,3,2,3,4,-1,A3,384
A,Canada,3,1,2,5,-3,A4,384
B,Ecuador,3,7,6,4,2,B1,384
B,Mexico,3,4,4,3,1,B2,384
B,Jamaica,3,3,4,4,0,B3,384
B,Venezuela,3,1,4,7,-3,B4,384
C,Uruguay,3,9,7,2,5,C1,384
C,United States,3,6,8,2,6,C2,384
C,Bolivia,3,1,3,7,-4,C3,384
C,Panama,3,1,2,9,-7,C4,384
D,Brazil,3,6,3,1,2,D1,384
D,Colombia,3,4,2,2,0,D2,384
D,Costa Rica,3,4,2,2,0,D3,384
D,Paraguay,3,2,0,2,-2,D4,384
A,Argentina,3,5,3,2,1,A1,385
A,Canada,3,4,4,4,0,A2,385
A,Chile,3,3,1,1,0,A3,385
A,Peru,3,2,0,1,-1,A4,385
B,Ecuador,3,7,9,3,6,B1,385
B,Jamaica,3,4,2,4,-2,B2,385
B,Mexico,3,3,2,5,-3,B3,385
B,Venezuela,3,2,1,2,-1,B4,385
C,Uruguay,3,6,4,2,2,C1,385
C,Bolivia,3,6,5,5,0,C2,385
C,United States,3,4,4,3,1,C3,385
C,Panama,3,1,2,5,-3,C4,385
D,Paraguay,3,6,5,4,1,D1,385
D,Brazil,3,4,5,4,1,D2,385
D,Colombia,3,4,5,5,0,D3,385
D,Costa Rica,3,3,4,6,-2,D4,385
A,Chile,3,7,5,1,4,A1,386
A,Argentina,3,6,5,4,1,A2,386
A,Peru,3,4,5,3,2,A3,386
A,Canada,3,0,2,9,-7,A4,386
B,Venezuela,3,6,2,4,-2,B1,386
B,Ecuador,3,4,5,4,1,B2,386
B,Mexico,3,4,3,2,1,B3,386
B,Jamaica,3,3,3,3,0,B4,386
C,United States,3,7,5,2,3,C1,386
C,Uruguay,3,6,4,2,2,C2,386
C,Panama,3,4,4,5,-1,C3,386
C,Bolivia,3,0,0,4,-4,C4,386
D,Colombia,3,9,7,1,6,D1,386
D,Paraguay,3,6,4,3,1,D2,386
D,Costa Rica,3,3,1,5,-4,D3,386
D,Brazil,3,0,1,4,-3,D4,386
A,Canada,3,9,5,2,3,A1,387
A,Argentina,3,6,6,2,4,A2,387
A,Chile,3,3,1,4,-3,A3,387
A,Peru,3,0,1,5,-4,A4,387
B,Jamaica,3,6,6,7,-1,B1,387
B,Mexico,3,5,10,7,3,B2,387
B,Ecuador,3,4,7,6,1,B3,387
B,Venezuela,3,1,2,5,-3,B4,387
C,Panama,3,6,3,1,2,C1,387
C,United States,3,6,2,1,1,C2,387
C,Uruguay,3,6,2,1,1,C3,387
C,Bolivia,3,0,0,4,-4,C4,387
D,Paraguay,3,5,3,0,3,D1,387
D,Colombia,3,5,4,2,2,D2,387
D,Brazil,3,3,0,0,0,D3,387
D,Costa Rica,3,1,2,7,-5,D4,387
A,Argentina,3,7,6,1,5,A1,388
A,Peru,3,4,4,4,0,A2,388
A,Chile,3,3,3,5,-2,A3,388
A,Canada,3,3,4,7,-3,A4,388
B,Jamaica,3,6,4,2,2,B1,388
B,Ecuador,3,6,5,4,1,B2,388
B,Mexico,3,3,6,7,-1,B3,388
B,Venezuela,3,3,4,6,-2,B4,388
C,Uruguay,3,9,7,1,6,C1,388
C,United States,3,6,8,4,4,C2,388
C,Bolivia,3,3,3,8,-5,C3,388
C,Panama,3,0,2,7,-5,C4,388
D,Brazil,3,9,7,0,7,D1,388
D,Colombia,3,4,3,3,0,D2,388
D,Costa Rica,3,4,2,3,-1,D3,388
D,Paraguay,3,0,0,6,-6,D4,388
A,Peru,3,7,6,3,3,A1,389
A,Chile,3,6,3,3,0,A2,389
A,Argentina,3,4,6,5,1,A3,389
A,Canada,3,0,2,6,-4,A4,389
B,Mexico,3,4,4,2,2,B1,389
B,Ecuador,3,4,2,2,0,B2,389
B,Jamaica,3,4,2,2,0,B3,389
B,Venezuela,3,4,2,4,-2,B4,389
C,Uruguay,3,7,8,1,7,C1,389
C,United States,3,6,6,4,2,C2,389
C,Panama,3,3,2,6,-4,C3,389
C,Bolivia,3,1,1,6,-5,C4,389
D,Brazil,3,7,7,1,6,D1,389
D,Colombia,3,4,3,1,2,D2,389
D,Costa Rica,3,3,2,5,-3,D3,389
D,Paraguay,3,3,1,6,-5,D4,389
A,Peru,3,7,6,4,2,A1,390
A,Chile,3,6,8,3,5,A2,390
A,Canada,3,3,4,7,-3,A3,390
A,Argentina,3,1,3,7,-4,A4,390
B,Venezuela,3,7,6,4,2,B1,390
B,Ecuador,3,6,6,3,3,B2,390
B,Mexico,3,4,4,4,0,B3,390
B,Jamaica,3,0,3,8,-5,B4,390
C,Uruguay,3,7,10,3,7,C1,390
C,United States,3,7,5,3,2,C2,390
C,Bolivia,3,3,4,5,-1,C3,390
C,Panama,3,0,1,9,-8,C4,390
D,Costa Rica,3,5,5,1,4,D1,390
D,Brazil,3,4,4,4,0,D2,390
D,Paraguay,3,4,2,2,0,D3,390
D,Colombia,3,3,2,6,-4,D4,390
A,Chile,3,6,4,3,1,A1,391
A,Peru,3,6,3,2,1,A2,391
A,Canada,3,4,1,1,0,A3,391
A,Argentina,3,1,1,3,-2,A4,391
B,Venezuela,3,6,5,5,0,B1,391
B,Mexico,3,4,4,1,3,B2,391
B,Jamaica,3,4,1,3,-2,B3,391
B,Ecuador,3,2,1,2,-1,B4,391
C,United States,3,9,5,1,4,C1,391
C,Uruguay,3,4,8,5,3,C2,391
C,Panama,3,4,4,4,0,C3,391
C,Bolivia,3,0,5,12,-7,C4,391
D,Brazil,3,9,8,1,7,D1,391
D,Colombia,3,6,4,3,1,D2,391
D,Costa Rica,3,1,0,3,-3,D3,391
D,Paraguay,3,1,0,5,-5,D4,391
A,Peru,3,7,2,0,2,A1,392
A,Chile,3,5,3,2,1,A2,392
A,Argentina,3,4,3,1,2,A3,392
A,Canada,3,0,2,7,-5,A4,392
B,Venezuela,3,5,8,4,4,B1,392
B,Mexico,3,5,4,3,1,B2,392
B,Jamaica,3,3,4,8,-4,B3,392
B,Ecuador,3,2,4,5,-1,B4,392
C,Uruguay,3,6,10,2,8,C1,392
C,Panama,3,6,5,4,1,C2,392
C,United States,3,6,6,6,0,C3,392
C,Bolivia,3,0,1,10,-9,C4,392
D,Brazil,3,6,8,2,6,D1,392
D,Costa Rica,3,6,4,3,1,D2,392
D,Colombia,3,4,1,2,-1,D3,392
D,Paraguay,3,1,1,7,-6,D4,392
A,Argentina,3,9,9,4,5,A1,393
A,Chile,3,6,5,3,2,A2,393
A,Canada,3,1,5,7,-2,A3,393
A,Peru,3,1,3,8,-5,A4,393
B,Mexico,3,7,7,1,6,B1,393
B,Ecuador,3,5,4,0,4,B2,393
B,Venezuela,3,2,2,4,-2,B3,393
B,Jamaica,3,1,3,11,-8,B4,393
C,Uruguay,3,7,5,3,2,C1,393
C,United States,3,6,6,3,3,C2,393
C,Bolivia,3,2,4,6,-2,C3,393
C,Panama,3,1,3,6,-3,C4,393
D,Brazil,3,7,7,1,6,D1,393
D,Colombia,3,6,5,2,3,D2,393
D,Paraguay,3,4,3,3,0,D3,393
D,Costa Rica,3,0,0,9,-9,D4,393
A,Argentina,3,9,6,2,4,A1,394
A,Peru,3,4,3,2,1,A2,394
A,Chile,3,3,1,3,-2,A3,394
A,Canada,3,1,3,6,-3,A4,394
B,Ecuador,3,9,6,2,4,B1,394
B,Venezuela,3,4,5,2,3,B2,394
B,Mexico,3,4,2,2,0,B3,394
B,Jamaica,3,0,1,8,-7,B4,394
C,Bolivia,3,6,6,5,1,C1,394
C,Panama,3,4,2,2,0,C2,394
C,United States,3,4,2,2,0,C3,394
C,Uruguay,3,3,4,5,-1,C4,394
D,Brazil,3,7,5,0,5,D1,394
D,Colombia,3,6,4,5,-1,D2,394
D,Costa Rica,3,3,2,4,-2,D3,394
D,Paraguay,3,1,0,2,-2,D4,394
A,Argentina,3,7,7,3,4,A1,395
A,Canada,3,4,3,5,-2,A2,395
A,Peru,3,3,4,4,0,A3,395
A,Chile,3,3,2,4,-2,A4,395
B,Mexico,3,7,7,2,5,B1,395
B,Ecuador,3,3,6,6,0,B2,395
B,Jamaica,3,2,2,3,-1,B3,395
B,Venezuela,3,2,2,6,-4,B4,395
C,Uruguay,3,7,4,2,2,C1,395
C,United States,3,5,8,4,4,C2,395
C,Panama,3,4,3,3,0,C3,395
C,Bolivia,3,0,2,8,-6,C4,395
D,Paraguay,3,6,5,3,2,D1,395
D,Colombia,3,5,4,3,1,D2,395
D,Brazil,3,4,3,2,1,D3,395
D,Costa Rica,3,1,0,4,-4,D4,395
A,Argentina,3,4,5,4,1,A1,396
A,Chile,3,4,2,2,0,A2,396
A,Canada,3,4,1,1,0,A3,396
A,Peru,3,4,3,4,-1,A4,396
B,Venezuela,3,5,7,3,4,B1,396
B,Ecuador,3,5,5,3,2,B2,396
B,Jamaica,3,3,1,6,-5,B3,396
B,Mexico,3,2,2,3,-1,B4,396
C,United States,3,7,6,1,5,C1,396
C,Uruguay,3,7,5,0,5,C2,396
C,Bolivia,3,1,2,6,-4,C3,396
C,Panama,3,1,1,7,-6,C4,396
D,Brazil,3,9,8,1,7,D1,396
D,Paraguay,3,4,3,4,-1,D2,396
D,Colombia,3,4,3,5,-2,D3,396
D,Costa Rica,3,0,1,5,-4,D4,396
A,Argentina,3,7,4,1,3,A1,397
A,Chile,3,6,4,3,1,A2,397
A,Peru,3,4,1,1,0,A3,397
A,Canada,3,0,0,4,-4,A4,397
B,Mexico,3,5,6,3,3,B1,397
B,Ecuador,3,4,4,4,0,B2,397
B,Venezuela,3,4,4,6,-2,B3,397
B,Jamaica,3,2,3,4,-1,B4,397
C,United States,3,7,8,3,5,C1,397
C,Uruguay,3,5,3,2,1,C2,397
C,Bolivia,3,4,3,2,1,C3,397
C,Panama,3,0,0,7,-7,C4,397
D,Brazil,3,7,4,2,2,D1,397
D,Colombia,3,7,3,1,2,D2,397
D,Paraguay,3,1,2,4,-2,D3,397
D,Costa Rica,3,1,1,3,-2,D4,397
A,Chile,3,5,4,2,2,A1,398
A,Peru,3,4,4,3,1,A2,398
A,Argentina,3,3,5,5,0,A3,398
A,Canada,3,2,2,5,-3,A4,398
B,Mexico,3,9,10,2,8,B1,398
B,Venezuela,3,4,6,5,1,B2,398
B,Ecuador,3,4,5,7,-2,B3,398
B,Jamaica,3,0,4,11,-7,B4,398
C,United States,3,6,5,4,1,C1,398
C,Bolivia,3,4,3,3,0,C2,398
C,Panama,3,4,2,2,0,C3,398
C,Uruguay,3,3,3,4,-1,C4,398
D,Brazil,3,5,3,1,2,D1,398
D,Colombia,3,5,3,1,2,D2,398
D,Costa Rica,3,2,1,3,-2,D3,398
D,Paraguay,3,2,1,3,-2,D4,398
A,Chile,3,9,4,1,3,A1,399
A,Argentina,3,6,6,2,4,A2,399
A,Peru,3,1,1,4,-3,A3,399
A,Canada,3,1,1,5,-4,A4,399
B,Jamaica,3,6,5,3,2,B1,399
B,Ecuador,3,4,3,3,0,B2,399
B,Mexico,3,4,1,2,-1,B3,399
B,Venezuela,3,3,3,4,-1,B4,399
C,United States,3,6,8,6,2,C1,399
C,Uruguay,3,6,7,6,1,C2,399
C,Panama,3,4,5,5,0,C3,399
C,Bolivia,3,1,3,6,-3,C4,399
D,Brazil,3,9,10,3,7,D1,399
D,Colombia,3,6,4,4,0,D2,399
D,Costa Rica,3,3,1,3,-2,D3,399
D,Paraguay,3,0,1,6,-5,D4,399
A,Argentina,3,5,6,2,4,A1,400
A,Chile,3,3,2,2,0,A2,400
A,Peru,3,3,1,1,0,A3,400
A,Canada,3,2,1,5,-4,A4,400
B,Mexico,3,9,7,0,7,B1,400
B,Ecuador,3,4,1,3,-2,B2,400
B,Venezuela,3,4,1,3,-2,B3,400
B,Jamaica,3,0,0,3,-3,B4,400
C,Uruguay,3,9,4,1,3,C1,400
C,United States,3,4,4,4,0,C2,400
C,Panama,3,4,2,2,0,C3,400
C,Bolivia,3,0,1,4,-3,C4,400
D,Brazil,3,9,10,2,8,D1,400
D,Colombia,3,4,4,3,1,D2,400
D,Paraguay,3,3,1,3,-2,D3,400
D,Costa Rica,3,1,2,9,-7,D4,400
A,Argentina,3,9,10,2,8,A1,401
A,Chile,3,4,4,3,1,A2,401
A,Peru,3,2,4,7,-3,A3,401
A,Canada,3,1,2,8,-6,A4,401
B,Ecuador,3,7,7,2,5,B1,401
B,Mexico,3,4,2,3,-1,B2,401
B,Venezuela,3,2,2,3,-1,B3,401
B,Jamaica,3,2,1,4,-3,B4,401
C,United States,3,7,8,3,5,C1,401
C,Bolivia,3,4,4,7,-3,C2,401
C,Uruguay,3,3,3,3,0,C3,401
C,Panama,3,2,3,5,-2,C4,401
D,Brazil,3,9,6,1,5,D1,401
D,Colombia,3,6,7,3,4,D2,401
D,Paraguay,3,1,1,5,-4,D3,401
D,Costa Rica,3,1,3,8,-5,D4,401
A,Argentina,3,7,6,2,4,A1,402
A,Canada,3,5,4,3,1,A2,402
A,Chile,3,2,3,4,-1,A3,402
A,Peru,3,1,0,4,-4,A4,402
B,Ecuador,3,7,5,0,5,B1,402
B,Mexico,3,6,2,2,0,B2,402
B,Venezuela,3,3,1,4,-3,B3,402
B,Jamaica,3,1,0,2,-2,B4,402
C,Uruguay,3,9,9,2,7,C1,402
C,United States,3,6,3,1,2,C2,402
C,Panama,3,1,3,7,-4,C3,402
C,Bolivia,3,1,3,8,-5,C4,402
D,Brazil,3,5,3,2,1,D1,402
D,Colombia,3,5,2,1,1,D2,402
D,Costa Rica,3,4,7,4,3,D3,402
D,Paraguay,3,1,0,5,-5,D4,402
A,Argentina,3,7,5,2,3,A1,403
A,Peru,3,5,4,2,2,A2,403
A,Canada,3,4,3,4,-1,A3,403
A,Chile,3,0,2,6,-4,A4,403
B,Mexico,3,9,9,0,9,B1,403
B,Jamaica,3,4,3,4,-1,B2,403
B,Ecuador,3,2,3,7,-4,B3,403
B,Venezuela,3,1,1,5,-4,B4,403
C,Uruguay,3,7,4,1,3,C1,403
C,Panama,3,6,5,4,1,C2,403
C,United States,3,4,3,2,1,C3,403
C,Bolivia,3,0,1,6,-5,C4,403
D,Brazil,3,7,7,2,5,D1,403
D,Colombia,3,5,6,3,3,D2,403
D,Paraguay,3,2,1,2,-1,D3,403
D,Costa Rica,3,1,0,7,-7,D4,403
A,Argentina,3,9,7,1,6,A1,404
A,Chile,3,4,4,4,0,A2,404
A,Canada,3,3,5,7,-2,A3,404
A,Peru,3,1,1,5,-4,A4,404
B,Venezuela,3,7,6,4,2,B1,404
B,Ecuador,3,6,5,4,1,B2,404
B,Mexico,3,4,5,5,0,B3,404
B,Jamaica,3,0,3,6,-3,B4,404
C,Uruguay,3,9,8,2,6,C1,404
C,Bolivia,3,6,9,9,0,C2,404
C,United States,3,1,4,7,-3,C3,404
C,Panama,3,1,3,6,-3,C4,404
D,Colombia,3,7,12,3,9,D1,404
D,Brazil,3,5,7,4,3,D2,404
D,Costa Rica,3,4,4,8,-4,D3,404
D,Paraguay,3,0,0,8,-8,D4,404
A,Argentina,3,7,4,2,2,A1,405
A,Peru,3,5,4,3,1,A2,405
A,Chile,3,2,2,3,-1,A3,405
A,Canada,3,1,3,5,-2,A4,405
B,Mexico,3,9,10,3,7,B1,405
B,Jamaica,3,2,4,5,-1,B2,405
B,Ecuador,3,2,3,5,-2,B3,405
B,Venezuela,3,2,2,6,-4,B4,405
C,United States,3,7,5,1,4,C1,405
C,Uruguay,3,4,1,2,-1,C2,405
C,Panama,3,3,1,1,0,C3,405
C,Bolivia,3,1,0,3,-3,C4,405
D,Brazil,3,7,6,0,6,D1,405
D,Colombia,3,5,2,1,1,D2,405
D,Costa Rica,3,2,2,5,-3,D3,405
D,Paraguay,3,1,1,5,-4,D4,405
A,Argentina,3,6,5,2,3,A1,406
A,Peru,3,5,3,2,1,A2,406
A,Chile,3,4,2,4,-2,A3,406
A,Canada,3,1,2,4,-2,A4,406
B,Mexico,3,7,6,2,4,B1,406
B,Ecuador,3,5,3,2,1,B2,406
B,Venezuela,3,3,1,2,-1,B3,406
B,Jamaica,3,1,0,4,-4,B4,406
C,Uruguay,3,7,10,4,6,C1,406
C,United States,3,4,5,5,0,C2,406
C,Panama,3,4,5,6,-1,C3,406
C,Bolivia,3,1,5,10,-5,C4,406
D,Brazil,3,6,7,3,4,D1,406
D,Colombia,3,6,4,2,2,D2,406
D,Paraguay,3,4,3,3,0,D3,406
D,Costa Rica,3,1,1,7,-6,D4,406
A,Argentina,3,7,6,1,5,A1,407
A,Peru,3,4,3,2,1,A2,407
A,Chile,3,4,2,3,-1,A3,407
A,Canada,3,1,1,6,-5,A4,407
B,Mexico,3,7,6,2,4,B1,407
B,Ecuador,3,4,1,1,0,B2,407
B,Venezuela,3,3,2,2,0,B3,407
B,Jamaica,3,1,0,4,-4,B4,407
C,United States,3,7,5,2,3,C1,407
C,Uruguay,3,6,6,4,2,C2,407
C,Bolivia,3,2,3,4,-1,C3,407
C,Panama,3,1,2,6,-4,C4,407
D,Colombia,3,7,3,1,2,D1,407
D,Brazil,3,6,3,2,1,D2,407
D,Paraguay,3,2,1,2,-1,D3,407
D,Costa Rica,3,1,1,3,-2,D4,407
A,Argentina,3,9,7,1,6,A1,408
A,Chile,3,6,6,5,1,A2,408
A,Peru,3,3,3,5,-2,A3,408
A,Canada,3,0,1,6,-5,A4,408
B,Ecuador,3,7,5,3,2,B1,408
B,Jamaica,3,6,5,3,2,B2,408
B,Mexico,3,3,2,3,-1,B3,408
B,Venezuela,3,1,3,6,-3,B4,408
C,United States,3,9,13,1,12,C1,408
C,Uruguay,3,3,3,4,-1,C2,408
C,Bolivia,3,3,4,9,-5,C3,408
C,Panama,3,3,2,8,-6,C4,408
D,Brazil,3,9,8,3,5,D1,408
D,Paraguay,3,4,3,5,-2,D2,408
D,Costa Rica,3,2,3,4,-1,D3,408
D,Colombia,3,1,4,6,-2,D4,408
A,Argentina,3,7,7,1,6,A1,409
A,Peru,3,4,4,3,1,A2,409
A,Canada,3,3,3,6,-3,A3,409
A,Chile,3,3,3,7,-4,A4,409
B,Mexico,3,9,3,0,3,B1,409
B,Ecuador,3,6,5,4,1,B2,409
B,Venezuela,3,3,4,4,0,B3,409
B,Jamaica,3,0,3,7,-4,B4,409
C,Uruguay,3,7,4,1,3,C1,409
C,Panama,3,7,4,2,2,C2,409
C,United States,3,3,3,3,0,C3,409
C,Bolivia,3,0,2,7,-5,C4,409
D,Brazil,3,7,5,1,4,D1,409
D,Costa Rica,3,6,3,3,0,D2,409
D,Paraguay,3,4,3,3,0,D3,409
D,Colombia,3,0,2,6,-4,D4,409
A,Argentina,3,7,6,0,6,A1,410
A,Chile,3,4,2,2,0,A2,410
A,Peru,3,4,3,6,-3,A3,410
A,Canada,3,1,1,4,-3,A4,410
B,Mexico,3,7,10,3,7,B1,410
B,Ecuador,3,5,5,3,2,B2,410
B,Venezuela,3,3,3,7,-4,B3,410
B,Jamaica,3,1,2,7,-5,B4,410
C,Uruguay,3,9,8,0,8,C1,410
C,Bolivia,3,3,2,3,-1,C2,410
C,United States,3,3,4,6,-2,C3,410
C,Panama,3,3,2,7,-5,C4,410
D,Brazil,3,7,4,2,2,D1,410
D,Colombia,3,4,5,4,1,D2,410
D,Paraguay,3,4,3,4,-1,D3,410
D,Costa Rica,3,1,5,7,-2,D4,410
A,Argentina,3,9,4,1,3,A1,411
A,Canada,3,6,7,6,1,A2,411
A,Chile,3,3,5,4,1,A3,411
A,Peru,3,0,4,9,-5,A4,411
B,Ecuador,3,7,7,1,6,B1,411
B,Mexico,3,4,2,2,0,B2,411
B,Venezuela,3,4,1,3,-2,B3,411
B,Jamaica,3,1,0,4,-4,B4,411
C,Uruguay,3,7,6,3,3,C1,411
C,United States,3,6,5,4,1,C2,411
C,Panama,3,3,4,6,-2,C3,411
C,Bolivia,3,1,4,6,-2,C4,411
D,Colombia,3,7,3,1,2,D1,411
D,Paraguay,3,4,5,2,3,D2,411
D,Brazil,3,4,2,2,0,D3,411
D,Costa Rica,3,1,1,6,-5,D4,411
A,Chile,3,6,8,6,2,A1,412
A,Argentina,3,4,5,4,1,A2,412
A,Canada,3,4,1,2,-1,A3,412
A,Peru,3,3,4,6,-2,A4,412
B,Venezuela,3,7,4,0,4,B1,412
B,Ecuador,3,6,3,2,1,B2,412
B,Mexico,3,3,2,3,-1,B3,412
B,Jamaica,3,1,0,4,-4,B4,412
C,Uruguay,3,9,7,2,5,C1,412
C,United States,3,4,2,2,0,C2,412
C,Panama,3,2,0,2,-2,C3,412
C,Bolivia,3,1,2,5,-3,C4,412
D,Colombia,3,7,5,2,3,D1,412
D,Brazil,3,4,3,3,0,D2,412
D,Costa Rica,3,3,4,5,-1,D3,412
D,Paraguay,3,3,3,5,-2,D4,412
A,Peru,3,5,2,1,1,A1,413
A,Canada,3,4,3,3,0,A2,413
A,Chile,3,4,2,2,0,A3,413
A,Argentina,3,2,4,5,-1,A4,413
B,Venezuela,3,7,2,0,2,B1,413
B,Ecuador,3,5,7,5,2,B2,413
B,Jamaica,3,3,3,5,-2,B3,413
B,Mexico,3,1,3,5,-2,B4,413
C,United States,3,9,8,2,6,C1,413
C,Uruguay,3,6,4,3,1,C2,413
C,Panama,3,1,1,3,-2,C3,413
C,Bolivia,3,1,1,6,-5,C4,413
D,Brazil,3,7,6,0,6,D1,413
D,Paraguay,3,4,1,1,0,D2,413
D,Costa Rica,3,4,1,4,-3,D3,413
D,Colombia,3,1,0,3,-3,D4,413
A,Argentina,3,9,7,2,5,A1,414
A,Peru,3,6,4,2,2,A2,414
A,Canada,3,1,3,6,-3,A3,414
A,Chile,3,1,2,6,-4,A4,414
B,Mexico,3,7,4,1,3,B1,414
B,Jamaica,3,6,4,3,1,B2,414
B,Ecuador,3,3,1,3,-2,B3,414
B,Venezuela,3,1,1,3,-2,B4,414
C,United States,3,7,9,3,6,C1,414
C,Panama,3,6,3,5,-2,C2,414
C,Uruguay,3,4,3,2,1,C3,414
C,Bolivia,3,0,2,7,-5,C4,414
D,Colombia,3,9,7,0,7,D1,414
D,Brazil,3,6,4,1,3,D2,414
D,Paraguay,3,3,3,5,-2,D3,414
D,Costa Rica,3,0,0,8,-8,D4,414
A,Argentina,3,7,3,1,2,A1,415
A,Peru,3,7,2,0,2,A2,415
A,Chile,3,3,4,3,1,A3,415
A,Canada,3,0,0,5,-5,A4,415
B,Jamaica,3,7,6,3,3,B1,415
B,Mexico,3,5,3,2,1,B2,415
B,Venezuela,3,2,4,5,-1,B3,415
B,Ecuador,3,1,1,4,-3,B4,415
C,Uruguay,3,6,6,3,3,C1,415
C,Panama,3,6,5,4,1,C2,415
C,United States,3,4,3,3,0,C3,415
C,Bolivia,3,1,1,5,-4,C4,415
D,Colombia,3,7,5,2,3,D1,415
D,Brazil,3,6,7,2,5,D2,415
D,Costa Rica,3,2,1,4,-3,D3,415
D,Paraguay,3,1,0,5,-5,D4,415
A,Argentina,3,7,6,2,4,A1,416
A,Canada,3,5,4,3,1,A2,416
A,Chile,3,3,3,5,-2,A3,416
A,Peru,3,1,1,4,-3,A4,416
B,Ecuador,3,7,5,1,4,B1,416
B,Venezuela,3,7,3,1,2,B2,416
B,Jamaica,3,3,2,3,-1,B3,416
B,Mexico,3,0,1,6,-5,B4,416
C,United States,3,7,4,2,2,C1,416
C,Uruguay,3,6,6,3,3,C2,416
C,Bolivia,3,4,4,2,2,C3,416
C,Panama,3,0,2,9,-7,C4,416
D,Brazil,3,5,2,0,2,D1,416
D,Colombia,3,3,1,1,0,D2,416
D,Costa Rica,3,3,1,1,0,D3,416
D,Paraguay,3,2,0,2,-2,D4,416
A,Argentina,3,7,11,1,10,A1,417
A,Canada,3,4,3,8,-5,A2,417
A,Chile,3,2,0,1,-1,A3,417
A,Peru,3,2,1,5,-4,A4,417
B,Ecuador,3,9,5,0,5,B1,417
B,Mexico,3,6,4,2,2,B2,417
B,Jamaica,3,1,0,2,-2,B3,417
B,Venezuela,3,1,0,5,-5,B4,417
C,Panama,3,5,4,1,3,C1,417
C,Uruguay,3,4,3,3,0,C2,417
C,United States,3,4,2,2,0,C3,417
C,Bolivia,3,3,3,6,-3,C4,417
D,Brazil,3,9,4,0,4,D1,417
D,Colombia,3,6,5,1,4,D2,417
D,Paraguay,3,3,3,4,-1,D3,417
D,Costa Rica,3,0,0,7,-7,D4,417
A,Canada,3,7,5,3,2,A1,418
A,Argentina,3,6,4,3,1,A2,418
A,Peru,3,3,3,4,-1,A3,418
A,Chile,3,1,3,5,-2,A4,418
B,Mexico,3,9,5,1,4,B1,418
B,Ecuador,3,4,3,4,-1,B2,418
B,Jamaica,3,2,4,5,-1,B3,418
B,Venezuela,3,1,1,3,-2,B4,418
C,Panama,3,9,4,1,3,C1,418
C,Uruguay,3,4,3,3,0,C2,418
C,United States,3,4,2,2,0,C3,418
C,Bolivia,3,0,0,3,-3,C4,418
D,Brazil,3,7,6,0,6,D1,418
D,Colombia,3,7,3,0,3,D2,418
D,Paraguay,3,3,1,4,-3,D3,418
D,Costa Rica,3,0,0,6,-6,D4,418
A,Peru,3,6,6,4,2,A1,419
A,Argentina,3,6,4,3,1,A2,419
A,Chile,3,3,3,3,0,A3,419
A,Canada,3,3,3,6,-3,A4,419
B,Ecuador,3,7,5,3,2,B1,419
B,Mexico,3,5,6,2,4,B2,419
B,Venezuela,3,4,6,5,1,B3,419
B,Jamaica,3,0,1,8,-7,B4,419
C,United States,3,7,2,0,2,C1,419
C,Panama,3,4,3,2,1,C2,419
C,Bolivia,3,3,2,2,0,C3,419
C,Uruguay,3,1,1,4,-3,C4,419
D,Brazil,3,9,6,0,6,D1,419
D,Colombia,3,6,6,2,4,D2,419
D,Paraguay,3,3,3,4,-1,D3,419
D,Costa Rica,3,0,0,9,-9,D4,419
A,Chile,3,5,8,4,4,A1,420
A,Argentina,3,5,5,3,2,A2,420
A,Peru,3,5,4,3,1,A3,420
A,Canada,3,0,0,7,-7,A4,420
B,Mexico,3,9,5,0,5,B1,420
B,Jamaica,3,6,3,3,0,B2,420
B,Venezuela,3,3,3,5,-2,B3,420
B,Ecuador,3,0,1,4,-3,B4,420
C,Uruguay,3,7,8,1,7,C1,420
C,United States,3,5,2,0,2,C2,420
C,Bolivia,3,3,3,9,-6,C3,420
C,Panama,3,1,1,4,-3,C4,420
D,Brazil,3,7,7,0,7,D1,420
D,Costa Rica,3,4,2,5,-3,D2,420
D,Colombia,3,2,0,1,-1,D3,420
D,Paraguay,3,2,1,4,-3,D4,420
A,Argentina,3,6,3,2,1,A1,421
A,Chile,3,5,1,0,1,A2,421
A,Peru,3,4,3,3,0,A3,421
A,Canada,3,1,1,3,-2,A4,421
B,Mexico,3,7,4,2,2,B1,421
B,Ecuador,3,6,8,5,3,B2,421
B,Jamaica,3,3,3,4,-1,B3,421
B,Venezuela,3,1,1,5,-4,B4,421
C,United States,3,5,5,4,1,C1,421
C,Bolivia,3,5,4,3,1,C2,421
C,Uruguay,3,4,2,2,0,C3,421
C,Panama,3,1,2,4,-2,C4,421
D,Brazil,3,7,7,1,6,D1,421
D,Colombia,3,7,7,3,4,D2,421
D,Costa Rica,3,3,3,7,-4,D3,421
D,Paraguay,3,0,1,7,-6,D4,421
A,Argentina,3,7,7,4,3,A1,422
A,Peru,3,4,2,2,0,A2,422
A,Chile,3,2,2,3,-1,A3,422
A,Canada,3,2,1,3,-2,A4,422
B,Ecuador,3,4,3,2,1,B1,422
B,Mexico,3,4,2,2,0,B2,422
B,Jamaica,3,4,2,3,-1,B3,422
B,Venezuela,3,3,1,1,0,B4,422
C,United States,3,5,5,3,2,C1,422
C,Panama,3,4,3,2,1,C2,422
C,Uruguay,3,4,2,3,-1,C3,422
C,Bolivia,3,2,3,5,-2,C4,422
D,Brazil,3,5,4,0,4,D1,422
D,Colombia,3,3,3,3,0,D2,422
D,Paraguay,3,3,1,1,0,D3,422
D,Costa Rica,3,2,2,6,-4,D4,422
A,Chile,3,7,5,2,3,A1,423
A,Argentina,3,5,4,3,1,A2,423
A,Canada,3,3,3,3,0,A3,423
A,Peru,3,1,1,5,-4,A4,423
B,Mexico,3,9,6,1,5,B1,423
B,Ecuador,3,4,3,4,-1,B2,423
B,Jamaica,3,4,2,3,-1,B3,423
B,Venezuela,3,0,2,5,-3,B4,423
C,United States,3,7,2,0,2,C1,423
C,Panama,3,6,6,4,2,C2,423
C,Uruguay,3,4,5,5,0,C3,423
C,Bolivia,3,0,0,4,-4,C4,423
D,Colombia,3,6,4,1,3,D1,423
D,Costa Rica,3,6,2,2,0,D2,423
D,Brazil,3,3,3,4,-1,D3,423
D,Paraguay,3,3,3,5,-2,D4,423
A,Argentina,3,6,5,2,3,A1,424
A,Peru,3,5,3,2,1,A2,424
A,Chile,3,4,2,2,0,A3,424
A,Canada,3,1,1,5,-4,A4,424
B,Ecuador,3,7,7,3,4,B1,424
B,Mexico,3,6,6,3,3,B2,424
B,Venezuela,3,2,2,5,-3,B3,424
B,Jamaica,3,1,1,5,-4,B4,424
C,Uruguay,3,7,8,2,6,C1,424
C,Bolivia,3,4,2,5,-3,C2,424
C,United States,3,2,3,4,-1,C3,424
C,Panama,3,2,2,4,-2,C4,424
D,Colombia,3,5,2,1,1,D1,424
D,Brazil,3,4,4,3,1,D2,424
D,Paraguay,3,3,5,5,0,D3,424
D,Costa Rica,3,2,2,4,-2,D4,424
A,Argentina,3,6,4,2,2,A1,425
A,Chile,3,4,5,4,1,A2,425
A,Peru,3,4,3,4,-1,A3,425
A,Canada,3,3,4,6,-2,A4,425
B,Mexico,3,7,4,2,2,B1,425
B,Jamaica,3,3,3,3,0,B2,425
B,Ecuador,3,2,5,6,-1,B3,425
B,Venezuela,3,2,4,5,-1,B4,425
C,Uruguay,3,9,11,2,9,C1,425
C,Bolivia,3,4,2,4,-2,C2,425
C,Panama,3,3,2,7,-5,C3,425
C,United States,3,1,2,4,-2,C4,425
D,Brazil,3,7,5,1,4,D1,425
D,Costa Rica,3,4,3,4,-1,D2,425
D,Colombia,3,3,2,2,0,D3,425
D,Paraguay,3,1,1,4,-3,D4,425
A,Argentina,3,5,4,2,2,A1,426
A,Peru,3,5,2,1,1,A2,426
A,Chile,3,3,3,3,0,A3,426
A,Canada,3,1,2,5,-3,A4,426
B,Mexico,3,9,7,2,5,B1,426
B,Ecuador,3,6,8,5,3,B2,426
B,Jamaica,3,3,1,3,-2,B3,426
B,Venezuela,3,0,1,7,-6,B4,426
C,United States,3,5,6,2,4,C1,426
C,Panama,3,4,6,5,1,C2,426
C,Uruguay,3,4,5,5,0,C3,426
C,Bolivia,3,3,3,8,-5,C4,426
D,Brazil,3,9,10,0,10,D1,426
D,Paraguay,3,3,1,3,-2,D2,426
D,Colombia,3,3,2,5,-3,D3,426
D,Costa Rica,3,3,2,7,-5,D4,426
A,Argentina,3,7,6,1,5,A1,427
A,Chile,3,4,4,3,1,A2,427
A,Peru,3,4,3,3,0,A3,427
A,Canada,3,1,1,7,-6,A4,427
B,Venezuela,3,7,5,3,2,B1,427
B,Mexico,3,6,7,2,5,B2,427
B,Ecuador,3,2,2,4,-2,B3,427
B,Jamaica,3,1,2,7,-5,B4,427
C,Uruguay,3,6,8,2,6,C1,427
C,Bolivia,3,6,4,5,-1,C2,427
C,United States,3,4,2,2,0,C3,427
C,Panama,3,1,2,7,-5,C4,427
D,Brazil,3,5,3,1,2,D1,427
D,Costa Rica,3,5,3,1,2,D2,427
D,Colombia,3,2,0,2,-2,D3,427
D,Paraguay,3,2,0,2,-2,D4,427
A,Chile,3,6,5,3,2,A1,428
A,Argentina,3,5,2,0,2,A2,428
A,Canada,3,4,3,4,-1,A3,428
A,Peru,3,1,2,5,-3,A4,428
B,Ecuador,3,5,5,2,3,B1,428
B,Mexico,3,4,3,3,0,B2,428
B,Jamaica,3,4,4,5,-1,B3,428
B,Venezuela,3,2,3,5,-2,B4,428
C,United States,3,5,5,3,2,C1,428
C,Panama,3,5,2,1,1,C2,428
C,Bolivia,3,3,3,3,0,C3,428
C,Uruguay,3,1,1,4,-3,C4,428
D,Brazil,3,7,4,1,3,D1,428
D,Colombia,3,4,3,3,0,D2,428
D,Costa Rica,3,3,2,3,-1,D3,428
D,Paraguay,3,3,1,3,-2,D4,428
A,Argentina,3,6,6,1,5,A1,429
A,Chile,3,4,3,3,0,A2,429
A,Canada,3,4,2,4,-2,A3,429
A,Peru,3,2,1,4,-3,A4,429
B,Venezuela,3,7,6,2,4,B1,429
B,Mexico,3,5,5,3,2,B2,429
B,Ecuador,3,2,1,2,-1,B3,429
B,Jamaica,3,1,0,5,-5,B4,429
C,Uruguay,3,7,11,3,8,C1,429
C,United States,3,7,9,1,8,C2,429
C,Panama,3,1,3,9,-6,C3,429
C,Bolivia,3,1,3,13,-10,C4,429
D,Colombia,3,6,6,2,4,D1,429
D,Costa Rica,3,4,4,4,0,D2,429
D,Brazil,3,4,2,3,-1,D3,429
D,Paraguay,3,2,3,6,-3,D4,429
A,Chile,3,7,7,4,3,A1,430
A,Argentina,3,5,5,2,3,A2,430
A,Canada,3,3,4,5,-1,A3,430
A,Peru,3,1,1,6,-5,A4,430
B,Mexico,3,6,5,3,2,B1,430
B,Venezuela,3,5,5,4,1,B2,430
B,Ecuador,3,4,6,6,0,B3,430
B,Jamaica,3,1,2,5,-3,B4,430
C,Uruguay,3,5,8,4,4,C1,430
C,United States,3,4,7,4,3,C2,430
C,Bolivia,3,4,4,7,-3,C3,430
C,Panama,3,2,2,6,-4,C4,430
D,Brazil,3,7,5,1,4,D1,430
D,Paraguay,3,4,2,2,0,D2,430
D,Colombia,3,3,1,2,-1,D3,430
D,Costa Rica,3,3,1,4,-3,D4,430
A,Argentina,3,9,12,3,9,A1,431
A,Canada,3,6,7,7,0,A2,431
A,Peru,3,1,4,8,-4,A3,431
A,Chile,3,1,3,8,-5,A4,431
B,Mexico,3,7,8,5,3,B1,431
B,Venezuela,3,4,5,6,-1,B2,431
B,Ecuador,3,3,3,3,0,B3,431
B,Jamaica,3,2,6,8,-2,B4,431
C,Uruguay,3,7,5,3,2,C1,431
C,United States,3,4,3,2,1,C2,431
C,Panama,3,3,2,2,0,C3,431
C,Bolivia,3,1,2,5,-3,C4,431
D,Colombia,3,7,7,2,5,D1,431
D,Brazil,3,5,4,2,2,D2,431
D,Costa Rica,3,4,3,3,0,D3,431
D,Paraguay,3,0,0,7,-7,D4,431
A,Argentina,3,7,8,3,5,A1,432
A,Peru,3,4,2,5,-3,A2,432
A,Chile,3,2,4,5,-1,A3,432
A,Canada,3,2,2,3,-1,A4,432
B,Ecuador,3,7,8,3,5,B1,432
B,Mexico,3,7,8,4,4,B2,432
B,Venezuela,3,3,6,6,0,B3,432
B,Jamaica,3,0,0,9,-9,B4,432
C,Uruguay,3,7,5,2,3,C1,432
C,Panama,3,4,2,2,0,C2,432
C,Bolivia,3,3,5,7,-2,C3,432
C,United States,3,2,5,6,-1,C4,432
D,Brazil,3,9,5,0,5,D1,432
D,Paraguay,3,2,2,3,-1,D2,432
D,Colombia,3,2,1,2,-1,D3,432
D,Costa Rica,3,2,1,4,-3,D4,432
A,Peru,3,9,10,1,9,A1,433
A,Chile,3,4,5,5,0,A2,433
A,Argentina,3,4,2,4,-2,A3,433
A,Canada,3,0,2,9,-7,A4,433
B,Ecuador,3,5,4,0,4,B1,433
B,Venezuela,3,5,4,3,1,B2,433
B,Mexico,3,4,4,3,1,B3,433
B,Jamaica,3,1,1,7,-6,B4,433
C,United States,3,7,6,3,3,C1,433
C,Uruguay,3,6,3,3,0,C2,433
C,Panama,3,3,4,5,-1,C3,433
C,Bolivia,3,1,1,3,-2,C4,433
D,Brazil,3,9,7,2,5,D1,433
D,Colombia,3,4,3,4,-1,D2,433
D,Paraguay,3,3,2,4,-2,D3,433
D,Costa Rica,3,1,3,5,-2,D4,433
A,Argentina,3,7,9,3,6,A1,434
A,Chile,3,7,7,5,2,A2,434
A,Canada,3,1,6,10,-4,A3,434
A,Peru,3,1,6,10,-4,A4,434
B,Ecuador,3,9,3,0,3,B1,434
B,Venezuela,3,4,4,1,3,B2,434
B,Jamaica,3,4,2,2,0,B3,434
B,Mexico,3,0,1,7,-6,B4,434
C,Uruguay,3,7,6,2,4,C1,434
C,United States,3,7,5,3,2,C2,434
C,Bolivia,3,3,2,3,-1,C3,434
C,Panama,3,0,1,6,-5,C4,434
D,Brazil,3,6,9,6,3,D1,434
D,Costa Rica,3,5,5,3,2,D2,434
D,Colombia,3,2,4,5,-1,D3,434
D,Paraguay,3,2,1,5,-4,D4,434
A,Chile,3,7,4,2,2,A1,435
A,Peru,3,6,5,2,3,A2,435
A,Argentina,3,4,6,4,2,A3,435
A,Canada,3,0,4,11,-7,A4,435
B,Ecuador,3,9,7,2,5,B1,435
B,Mexico,3,4,3,3,0,B2,435
B,Jamaica,3,2,2,5,-3,B3,435
B,Venezuela,3,1,2,4,-2,B4,435
C,United States,3,7,7,1,6,C1,435
C,Uruguay,3,5,3,2,1,C2,435
C,Panama,3,2,1,3,-2,C3,435
C,Bolivia,3,1,0,5,-5,C4,435
D,Brazil,3,9,7,1,6,D1,435
D,Colombia,3,4,4,3,1,D2,435
D,Paraguay,3,3,6,7,-1,D3,435
D,Costa Rica,3,1,3,9,-6,D4,435
A,Argentina,3,9,7,2,5,A1,436
A,Chile,3,4,3,4,-1,A2,436
A,Canada,3,4,2,3,-1,A3,436
A,Peru,3,0,1,4,-3,A4,436
B,Ecuador,3,6,5,3,2,B1,436
B,Venezuela,3,4,4,4,0,B2,436
B,Mexico,3,4,2,2,0,B3,436
B,Jamaica,3,2,4,6,-2,B4,436
C,United States,3,7,3,0,3,C1,436
C,Uruguay,3,6,7,4,3,C2,436
C,Panama,3,2,3,4,-1,C3,436
C,Bolivia,3,1,2,7,-5,C4,436
D,Brazil,3,6,10,2,8,D1,436
D,Colombia,3,6,3,4,-1,D2,436
D,Paraguay,3,3,2,3,-1,D3,436
D,Costa Rica,3,3,1,7,-6,D4,436
A,Peru,3,9,4,1,3,A1,437
A,Argentina,3,4,5,3,2,A2,437
A,Canada,3,2,5,6,-1,A3,437
A,Chile,3,1,2,6,-4,A4,437
B,Venezuela,3,5,5,1,4,B1,437
B,Mexico,3,5,5,4,1,B2,437
B,Ecuador,3,3,3,3,0,B3,437
B,Jamaica,3,1,2,7,-5,B4,437
C,United States,3,7,6,3,3,C1,437
C,Uruguay,3,4,4,4,0,C2,437
C,Bolivia,3,2,4,5,-1,C3,437
C,Panama,3,2,2,4,-2,C4,437
D,Brazil,3,7,4,2,2,D1,437
D,Colombia,3,5,4,3,1,D2,437
D,Paraguay,3,4,4,4,0,D3,437
D,Costa Rica,3,0,2,5,-3,D4,437
A,Argentina,3,5,6,3,3,A1,438
A,Chile,3,4,1,3,-2,A2,438
A,Peru,3,3,2,2,0,A3,438
A,Canada,3,2,3,4,-1,A4,438
B,Jamaica,3,9,5,1,4,B1,438
B,Ecuador,3,2,2,3,-1,B2,438
B,Venezuela,3,2,2,3,-1,B3,438
B,Mexico,3,2,3,5,-2,B4,438
C,United States,3,9,6,0,6,C1,438
C,Uruguay,3,2,3,4,-1,C2,438
C,Panama,3,2,1,3,-2,C3,438
C,Bolivia,3,2,2,5,-3,C4,438
D,Brazil,3,7,7,0,7,D1,438
D,Costa Rica,3,6,4,8,-4,D2,438
D,Colombia,3,3,3,4,-1,D3,438
D,Paraguay,3,1,0,2,-2,D4,438
A,Argentina,3,7,6,2,4,A1,439
A,Peru,3,4,4,4,0,A2,439
A,Chile,3,4,3,4,-1,A3,439
A,Canada,3,1,2,5,-3,A4,439
B,Ecuador,3,9,7,1,6,B1,439
B,Mexico,3,4,3,3,0,B2,439
B,Jamaica,3,3,3,6,-3,B3,439
B,Venezuela,3,1,1,4,-3,B4,439
C,Uruguay,3,7,4,1,3,C1,439
C,United States,3,5,3,2,1,C2,439
C,Bolivia,3,3,5,5,0,C3,439
C,Panama,3,1,1,5,-4,C4,439
D,Brazil,3,6,5,3,2,D1,439
D,Colombia,3,6,5,3,2,D2,439
D,Costa Rica,3,3,2,3,-1,D3,439
D,Paraguay,3,3,3,6,-3,D4,439
A,Canada,3,7,5,3,2,A1,440
A,Peru,3,4,5,5,0,A2,440
A,Argentina,3,3,5,4,1,A3,440
A,Chile,3,3,2,5,-3,A4,440
B,Ecuador,3,7,5,2,3,B1,440
B,Venezuela,3,4,3,3,0,B2,440
B,Mexico,3,2,3,4,-1,B3,440
B,Jamaica,3,2,1,3,-2,B4,440
C,United States,3,7,5,2,3,C1,440
C,Uruguay,3,5,6,4,2,C2,440
C,Panama,3,3,3,4,-1,C3,440
C,Bolivia,3,1,1,5,-4,C4,440
D,Colombia,3,5,3,1,2,D1,440
D,Brazil,3,5,2,0,2,D2,440
D,Costa Rica,3,4,2,3,-1,D3,440
D,Paraguay,3,1,0,3,-3,D4,440
A,Canada,3,7,6,3,3,A1,441
A,Argentina,3,3,3,3,0,A2,441
A,Chile,3,2,3,4,-1,A3,441
A,Peru,3,2,1,3,-2,A4,441
B,Mexico,3,7,11,4,7,B1,441
B,Venezuela,3,6,4,2,2,B2,441
B,Ecuador,3,4,5,5,0,B3,441
B,Jamaica,3,0,1,10,-9,B4,441
C,Uruguay,3,9,4,0,4,C1,441
C,Bolivia,3,3,3,4,-1,C2,441
C,United States,3,3,2,3,-1,C3,441
C,Panama,3,3,2,4,-2,C4,441
D,Paraguay,3,9,5,0,5,D1,441
D,Colombia,3,4,3,5,-2,D2,441
D,Brazil,3,2,2,3,-1,D3,441
D,Costa Rica,3,1,0,2,-2,D4,441
A,Argentina,3,6,8,3,5,A1,442
A,Canada,3,6,6,4,2,A2,442
A,Peru,3,3,3,6,-3,A3,442
A,Chile,3,3,2,6,-4,A4,442
B,Mexico,3,9,8,1,7,B1,442
B,Ecuador,3,6,4,3,1,B2,442
B,Venezuela,3,3,4,5,-1,B3,442
B,Jamaica,3,0,0,7,-7,B4,442
C,United States,3,7,5,1,4,C1,442
C,Bolivia,3,4,4,6,-2,C2,442
C,Uruguay,3,2,5,6,-1,C3,442
C,Panama,3,2,1,2,-1,C4,442
D,Colombia,3,7,5,2,3,D1,442
D,Brazil,3,6,6,4,2,D2,442
D,Paraguay,3,3,6,6,0,D3,442
D,Costa Rica,3,1,4,9,-5,D4,442
A,Chile,3,7,2,0,2,A1,443
A,Argentina,3,6,3,1,2,A2,443
A,Canada,3,2,0,2,-2,A3,443
A,Peru,3,1,0,2,-2,A4,443
B,Venezuela,3,7,3,1,2,B1,443
B,Ecuador,3,6,6,1,5,B2,443
B,Mexico,3,3,4,4,0,B3,443
B,Jamaica,3,1,1,8,-7,B4,443
C,Bolivia,3,5,5,4,1,C1,443
C,United States,3,5,5,4,1,C2,443
C,Uruguay,3,4,5,4,1,C3,443
C,Panama,3,1,1,4,-3,C4,443
D,Brazil,3,9,11,1,10,D1,443
D,Paraguay,3,6,2,4,-2,D2,443
D,Colombia,3,3,3,4,-1,D3,443
D,Costa Rica,3,0,1,8,-7,D4,443
A,Argentina,3,7,3,1,2,A1,444
A,Peru,3,6,4,2,2,A2,444
A,Chile,3,4,2,1,1,A3,444
A,Canada,3,0,0,5,-5,A4,444
B,Ecuador,3,7,5,2,3,B1,444
B,Mexico,3,5,6,4,2,B2,444
B,Jamaica,3,4,5,6,-1,B3,444
B,Venezuela,3,0,2,6,-4,B4,444
C,United States,3,9,6,2,4,C1,444
C,Uruguay,3,4,8,3,5,C2,444
C,Bolivia,3,4,5,5,0,C3,444
C,Panama,3,0,1,10,-9,C4,444
D,Colombia,3,6,6,4,2,D1,444
D,Costa Rica,3,6,4,3,1,D2,444
D,Brazil,3,3,4,5,-1,D3,444
D,Paraguay,3,3,5,7,-2,D4,444
A,Argentina,3,9,5,1,4,A1,445
A,Chile,3,4,5,4,1,A2,445
A,Canada,3,4,3,4,-1,A3,445
A,Peru,3,0,0,4,-4,A4,445
B,Ecuador,3,9,11,2,9,B1,445
B,Mexico,3,6,6,4,2,B2,445
B,Jamaica,3,3,2,6,-4,B3,445
B,Venezuela,3,0,1,8,-7,B4,445
C,United States,3,5,7,4,3,C1,445
C,Panama,3,5,7,5,2,C2,445
C,Uruguay,3,5,5,3,2,C3,445
C,Bolivia,3,0,2,9,-7,C4,445
D,Brazil,3,7,4,1,3,D1,445
D,Colombia,3,6,5,1,4,D2,445
D,Costa Rica,3,3,2,5,-3,D3,445
D,Paraguay,3,1,0,4,-4,D4,445
A,Argentina,3,5,3,2,1,A1,446
A,Chile,3,5,2,1,1,A2,446
A,Peru,3,3,1,2,-1,A3,446
A,Canada,3,2,3,4,-1,A4,446
B,Mexico,3,9,9,4,5,B1,446
B,Ecuador,3,4,5,6,-1,B2,446
B,Venezuela,3,2,4,5,-1,B3,446
B,Jamaica,3,1,4,7,-3,B4,446
C,United States,3,7,6,1,5,C1,446
C,Bolivia,3,4,2,4,-2,C2,446
C,Uruguay,3,3,0,0,0,C3,446
C,Panama,3,1,1,4,-3,C4,446
D,Paraguay,3,7,6,3,3,D1,446
D,Brazil,3,5,5,3,2,D2,446
D,Colombia,3,3,2,4,-2,D3,446
D,Costa Rica,3,1,2,5,-3,D4,446
A,Argentina,3,7,7,3,4,A1,447
A,Peru,3,4,5,4,1,A2,447
A,Chile,3,3,3,3,0,A3,447
A,Canada,3,1,4,9,-5,A4,447
B,Ecuador,3,9,5,2,3,B1,447
B,Mexico,3,4,5,4,1,B2,447
B,Jamaica,3,2,3,4,-1,B3,447
B,Venezuela,3,1,2,5,-3,B4,447
C,United States,3,7,9,4,5,C1,447
C,Uruguay,3,3,3,3,0,C2,447
C,Panama,3,2,5,6,-1,C3,447
C,Bolivia,3,2,2,6,-4,C4,447
D,Brazil,3,7,6,1,5,D1,447
D,Colombia,3,6,4,1,3,D2,447
D,Paraguay,3,2,3,6,-3,D3,447
D,Costa Rica,3,1,2,7,-5,D4,447
A,Peru,3,7,5,3,2,A1,448
A,Canada,3,5,5,4,1,A2,448
A,Argentina,3,3,6,6,0,A3,448
A,Chile,3,1,5,8,-3,A4,448
B,Mexico,3,7,8,5,3,B1,448
B,Venezuela,3,6,6,2,4,B2,448
B,Jamaica,3,2,2,5,-3,B3,448
B,Ecuador,3,1,4,8,-4,B4,448
C,United States,3,9,9,2,7,C1,448
C,Uruguay,3,6,2,4,-2,C2,448
C,Panama,3,3,3,4,-1,C3,448
C,Bolivia,3,0,2,6,-4,C4,448
D,Costa Rica,3,7,6,4,2,D1,448
D,Brazil,3,6,4,3,1,D2,448
D,Paraguay,3,2,2,3,-1,D3,448
D,Colombia,3,1,4,6,-2,D4,448
A,Canada,3,5,5,3,2,A1,449
A,Argentina,3,4,3,3,0,A2,449
A,Chile,3,4,3,3,0,A3,449
A,Peru,3,2,1,3,-2,A4,449
B,Ecuador,3,9,5,1,4,B1,449
B,Venezuela,3,4,4,3,1,B2,449
B,Mexico,3,4,2,1,1,B3,449
B,Jamaica,3,0,2,8,-6,B4,449
C,Uruguay,3,7,4,1,3,C1,449
C,United States,3,6,2,1,1,C2,449
C,Bolivia,3,2,2,3,-1,C3,449
C,Panama,3,1,1,4,-3,C4,449
D,Brazil,3,7,6,1,5,D1,449
D,Paraguay,3,4,1,3,-2,D2,449
D,Colombia,3,2,2,3,-1,D3,449
D,Costa Rica,3,2,1,3,-2,D4,449
A,Argentina,3,9,7,1,6,A1,450
A,Peru,3,6,4,2,2,A2,450
A,Chile,3,3,5,7,-2,A3,450
A,Canada,3,0,1,7,-6,A4,450
B,Ecuador,3,7,6,3,3,B1,450
B,Venezuela,3,6,6,4,2,B2,450
B,Mexico,3,2,5,7,-2,B3,450
B,Jamaica,3,1,4,7,-3,B4,450
C,Uruguay,3,7,8,2,6,C1,450
C,United States,3,6,6,3,3,C2,450
C,Panama,3,4,2,3,-1,C3,450
C,Bolivia,3,0,1,9,-8,C4,450
D,Colombia,3,7,6,0,6,D1,450
D,Brazil,3,7,4,0,4,D2,450
D,Costa Rica,3,3,2,5,-3,D3,450
D,Paraguay,3,0,1,8,-7,D4,450
A,Argentina,3,7,7,1,6,A1,451
A,Chile,3,4,3,2,1,A2,451
A,Canada,3,4,4,5,-1,A3,451
A,Peru,3,1,2,8,-6,A4,451
B,Ecuador,3,9,8,2,6,B1,451
B,Venezuela,3,4,3,3,0,B2,451
B,Mexico,3,3,5,5,0,B3,451
B,Jamaica,3,1,3,9,-6,B4,451
C,Panama,3,6,3,1,2,C1,451
C,Uruguay,3,6,3,3,0,C2,451
C,United States,3,3,4,4,0,C3,451
C,Bolivia,3,3,2,4,-2,C4,451
D,Brazil,3,7,7,2,5,D1,451
D,Colombia,3,7,4,2,2,D2,451
D,Paraguay,3,3,3,4,-1,D3,451
D,Costa Rica,3,0,2,8,-6,D4,451
A,Argentina,3,7,8,3,5,A1,452
A,Chile,3,6,5,4,1,A2,452
A,Peru,3,4,2,2,0,A3,452
A,Canada,3,0,0,6,-6,A4,452
B,Mexico,3,7,4,2,2,B1,452
B,Ecuador,3,6,8,3,5,B2,452
B,Jamaica,3,3,1,6,-5,B3,452
B,Venezuela,3,1,2,4,-2,B4,452
C,Panama,3,7,6,3,3,C1,452
C,Uruguay,3,4,4,3,1,C2,452
C,United States,3,4,6,6,0,C3,452
C,Bolivia,3,1,2,6,-4,C4,452
D,Colombia,3,7,4,1,3,D1,452
D,Paraguay,3,6,3,2,1,D2,452
D,Brazil,3,3,2,3,-1,D3,452
D,Costa Rica,3,1,1,4,-3,D4,452
A,Argentina,3,9,7,2,5,A1,453
A,Chile,3,6,2,1,1,A2,453
A,Canada,3,3,3,2,1,A3,453
A,Peru,3,0,2,9,-7,A4,453
B,Ecuador,3,7,3,0,3,B1,453
B,Venezuela,3,4,2,2,0,B2,453
B,Mexico,3,2,0,1,-1,B3,453
B,Jamaica,3,2,1,3,-2,B4,453
C,Uruguay,3,9,10,2,8,C1,453
C,United States,3,4,6,6,0,C2,453
C,Panama,3,4,7,10,-3,C3,453
C,Bolivia,3,0,4,9,-5,C4,453
D,Brazil,3,9,11,0,11,D1,453
D,Paraguay,3,6,5,2,3,D2,453
D,Colombia,3,3,1,5,-4,D3,453
D,Costa Rica,3,0,0,10,-10,D4,453
A,Argentina,3,9,10,4,6,A1,454
A,Peru,3,4,5,5,0,A2,454
A,Chile,3,3,3,4,-1,A3,454
A,Canada,3,1,3,8,-5,A4,454
B,Venezuela,3,7,9,4,5,B1,454
B,Ecuador,3,5,4,3,1,B2,454
B,Mexico,3,2,1,2,-1,B3,454
B,Jamaica,3,1,0,5,-5,B4,454
C,Uruguay,3,7,6,1,5,C1,454
C,United States,3,5,8,4,4,C2,454
C,Panama,3,4,3,3,0,C3,454
C,Bolivia,3,0,1,10,-9,C4,454
D,Brazil,3,7,4,1,3,D1,454
D,Colombia,3,5,2,1,1,D2,454
D,Costa Rica,3,3,4,4,0,D3,454
D,Paraguay,3,1,1,5,-4,D4,454
A,Argentina,3,6,5,5,0,A1,455
A,Chile,3,5,6,1,5,A2,455
A,Peru,3,2,4,6,-2,A3,455
A,Canada,3,2,3,6,-3,A4,455
B,Ecuador,3,7,8,5,3,B1,455
B,Mexico,3,5,6,4,2,B2,455
B,Venezuela,3,3,5,7,-2,B3,455
B,Jamaica,3,1,2,5,-3,B4,455
C,United States,3,7,4,2,2,C1,455
C,Panama,3,6,5,3,2,C2,455
C,Uruguay,3,3,2,4,-2,C3,455
C,Bolivia,3,1,1,3,-2,C4,455
D,Brazil,3,9,7,1,6,D1,455
D,Colombia,3,3,3,3,0,D2,455
D,Paraguay,3,3,1,3,-2,D3,455
D,Costa Rica,3,3,1,5,-4,D4,455
A,Chile,3,7,5,2,3,A1,456
A,Argentina,3,6,7,4,3,A2,456
A,Peru,3,3,2,5,-3,A3,456
A,Canada,3,1,5,8,-3,A4,456
B,Venezuela,3,7,5,3,2,B1,456
B,Mexico,3,5,2,1,1,B2,456
B,Ecuador,3,4,4,3,1,B3,456
B,Jamaica,3,0,4,8,-4,B4,456
C,Uruguay,3,6,5,2,3,C1,456
C,United States,3,6,4,1,3,C2,456
C,Panama,3,3,2,4,-2,C3,456
C,Bolivia,3,3,2,6,-4,C4,456
D,Brazil,3,9,12,0,12,D1,456
D,Colombia,3,4,2,2,0,D2,456
D,Paraguay,3,2,2,8,-6,D3,456
D,Costa Rica,3,1,1,7,-6,D4,456
A,Argentina,3,9,6,2,4,A1,457
A,Chile,3,4,2,2,0,A2,457
A,Peru,3,3,3,4,-1,A3,457
A,Canada,3,1,1,4,-3,A4,457
B,Mexico,3,7,8,3,5,B1,457
B,Ecuador,3,4,5,3,2,B2,457
B,Venezuela,3,3,5,6,-1,B3,457
B,Jamaica,3,3,2,8,-6,B4,457
C,Uruguay,3,6,6,2,4,C1,457
C,United States,3,6,6,3,3,C2,457
C,Panama,3,6,4,5,-1,C3,457
C,Bolivia,3,0,3,9,-6,C4,457
D,Brazil,3,5,2,1,1,D1,457
D,Costa Rica,3,4,4,3,1,D2,457
D,Paraguay,3,4,1,2,-1,D3,457
D,Colombia,3,2,1,2,-1,D4,457
A,Argentina,3,9,7,1,6,A1,458
A,Chile,3,4,2,2,0,A2,458
A,Peru,3,4,5,6,-1,A3,458
A,Canada,3,0,1,6,-5,A4,458
B,Mexico,3,7,4,1,3,B1,458
B,Ecuador,3,4,3,2,1,B2,458
B,Venezuela,3,4,5,6,-1,B3,458
B,Jamaica,3,1,4,7,-3,B4,458
C,Uruguay,3,7,10,3,7,C1,458
C,United States,3,5,4,3,1,C2,458
C,Panama,3,3,7,8,-1,C3,458
C,Bolivia,3,1,2,9,-7,C4,458
D,Brazil,3,9,11,1,10,D1,458
D,Colombia,3,6,3,2,1,D2,458
D,Paraguay,3,3,2,4,-2,D3,458
D,Costa Rica,3,0,2,11,-9,D4,458
A,Argentina,3,9,6,1,5,A1,459
A,Chile,3,6,4,2,2,A2,459
A,Canada,3,3,2,5,-3,A3,459
A,Peru,3,0,0,4,-4,A4,459
B,Venezuela,3,6,5,3,2,B1,459
B,Mexico,3,4,3,2,1,B2,459
B,Jamaica,3,4,4,4,0,B3,459
B,Ecuador,3,3,1,4,-3,B4,459
C,Uruguay,3,7,8,1,7,C1,459
C,United States,3,7,6,2,4,C2,459
C,Bolivia,3,3,3,7,-4,C3,459
C,Panama,3,0,0,7,-7,C4,459
D,Costa Rica,3,7,4,2,2,D1,459
D,Brazil,3,5,4,1,3,D2,459
D,Colombia,3,3,2,5,-3,D3,459
D,Paraguay,3,1,0,2,-2,D4,459
A,Argentina,3,7,8,3,5,A1,460
A,Canada,3,5,4,3,1,A2,460
A,Peru,3,2,0,1,-1,A3,460
A,Chile,3,1,2,7,-5,A4,460
B,Ecuador,3,5,3,0,3,B1,460
B,Mexico,3,5,4,3,1,B2,460
B,Jamaica,3,2,2,3,-1,B3,460
B,Venezuela,3,2,3,6,-3,B4,460
C,Uruguay,3,6,4,1,3,C1,460
C,United States,3,4,4,4,0,C2,460
C,Bolivia,3,4,4,5,-1,C3,460
C,Panama,3,3,4,6,-2,C4,460
D,Brazil,3,9,8,3,5,D1,460
D,Paraguay,3,4,3,3,0,D2,460
D,Colombia,3,2,1,2,-1,D3,460
D,Costa Rica,3,1,1,5,-4,D4,460
A,Argentina,3,7,5,2,3,A1,461
A,Peru,3,4,2,2,0,A2,461
A,Canada,3,4,3,4,-1,A3,461
A,Chile,3,1,3,5,-2,A4,461
B,Ecuador,3,7,7,2,5,B1,461
B,Mexico,3,5,3,2,1,B2,461
B,Venezuela,3,4,6,4,2,B3,461
B,Jamaica,3,0,0,8,-8,B4,461
C,United States,3,7,6,3,3,C1,461
C,Uruguay,3,5,5,3,2,C2,461
C,Panama,3,3,5,4,1,C3,461
C,Bolivia,3,1,1,7,-6,C4,461
D,Brazil,3,7,4,1,3,D1,461
D,Colombia,3,6,5,3,2,D2,461
D,Costa Rica,3,3,3,4,-1,D3,461
D,Paraguay,3,1,0,4,-4,D4,461
A,Peru,3,9,5,1,4,A1,462
A,Argentina,3,4,3,4,-1,A2,462
A,Chile,3,3,5,2,3,A3,462
A,Canada,3,1,1,7,-6,A4,462
B,Ecuador,3,7,5,2,3,B1,462
B,Mexico,3,5,5,2,3,B2,462
B,Venezuela,3,2,4,6,-2,B3,462
B,Jamaica,3,1,2,6,-4,B4,462
C,Uruguay,3,9,7,3,4,C1,462
C,United States,3,6,3,2,1,C2,462
C,Panama,3,3,4,3,1,C3,462
C,Bolivia,3,0,2,8,-6,C4,462
D,Colombia,3,7,7,0,7,D1,462
D,Brazil,3,4,6,1,5,D2,462
D,Paraguay,3,4,2,2,0,D3,462
D,Costa Rica,3,1,1,13,-12,D4,462
A,Argentina,3,9,7,2,5,A1,463
A,Canada,3,4,4,5,-1,A2,463
A,Peru,3,2,3,4,-1,A3,463
A,Chile,3,1,2,5,-3,A4,463
B,Ecuador,3,5,4,1,3,B1,463
B,Mexico,3,5,3,2,1,B2,463
B,Venezuela,3,3,3,3,0,B3,463
B,Jamaica,3,1,0,4,-4,B4,463
C,Uruguay,3,6,9,7,2,C1,463
C,United States,3,5,7,3,4,C2,463
C,Panama,3,2,3,5,-2,C3,463
C,Bolivia,3,2,3,7,-4,C4,463
D,Colombia,3,7,6,2,4,D1,463
D,Brazil,3,5,6,2,4,D2,463
D,Paraguay,3,2,2,3,-1,D3,463
D,Costa Rica,3,1,0,7,-7,D4,463
A,Chile,3,6,3,2,1,A1,464
A,Argentina,3,4,4,2,2,A2,464
A,Peru,3,4,1,2,-1,A3,464
A,Canada,3,3,2,4,-2,A4,464
B,Mexico,3,6,5,4,1,B1,464
B,Venezuela,3,6,5,4,1,B2,464
B,Ecuador,3,6,4,3,1,B3,464
B,Jamaica,3,0,2,5,-3,B4,464
C,Uruguay,3,9,9,2,7,C1,464
C,United States,3,6,5,3,2,C2,464
C,Panama,3,3,2,6,-4,C3,464
C,Bolivia,3,0,3,8,-5,C4,464
D,Brazil,3,7,6,2,4,D1,464
D,Colombia,3,6,5,3,2,D2,464
D,Paraguay,3,4,2,2,0,D3,464
D,Costa Rica,3,0,1,7,-6,D4,464
A,Argentina,3,6,6,1,5,A1,465
A,Chile,3,6,6,4,2,A2,465
A,Peru,3,6,3,4,-1,A3,465
A,Canada,3,0,2,8,-6,A4,465
B,Mexico,3,7,6,3,3,B1,465
B,Jamaica,3,4,1,2,-1,B2,465
B,Venezuela,3,2,4,5,-1,B3,465
B,Ecuador,3,2,1,2,-1,B4,465
C,Uruguay,3,9,6,0,6,C1,465
C,United States,3,6,6,1,5,C2,465
C,Bolivia,3,3,5,8,-3,C3,465
C,Panama,3,0,2,10,-8,C4,465
D,Brazil,3,7,6,2,4,D1,465
D,Paraguay,3,4,2,4,-2,D2,465
D,Costa Rica,3,2,2,3,-1,D3,465
D,Colombia,3,2,1,2,-1,D4,465
A,Argentina,3,7,8,2,6,A1,466
A,Peru,3,4,5,4,1,A2,466
A,Chile,3,4,4,4,0,A3,466
A,Canada,3,1,2,9,-7,A4,466
B,Mexico,3,9,8,2,6,B1,466
B,Ecuador,3,6,6,6,0,B2,466
B,Venezuela,3,3,3,6,-3,B3,466
B,Jamaica,3,0,2,5,-3,B4,466
C,Bolivia,3,7,5,1,4,C1,466
C,Panama,3,6,5,4,1,C2,466
C,United States,3,3,2,5,-3,C3,466
C,Uruguay,3,1,2,4,-2,C4,466
D,Brazil,3,9,7,0,7,D1,466
D,Colombia,3,2,1,3,-2,D2,466
D,Costa Rica,3,2,0,2,-2,D3,466
D,Paraguay,3,2,1,4,-3,D4,466
A,Argentina,3,9,7,1,6,A1,467
A,Peru,3,4,1,2,-1,A2,467
A,Chile,3,2,2,4,-2,A3,467
A,Canada,3,1,1,4,-3,A4,467
B,Mexico,3,7,6,3,3,B1,467
B,Jamaica,3,4,5,4,1,B2,467
B,Venezuela,3,4,2,2,0,B3,467
B,Ecuador,3,1,3,7,-4,B4,467
C,United States,3,7,8,2,6,C1,467
C,Uruguay,3,6,6,4,2,C2,467
C,Panama,3,2,3,5,-2,C3,467
C,Bolivia,3,1,1,7,-6,C4,467
D,Brazil,3,9,8,3,5,D1,467
D,Paraguay,3,6,8,5,3,D2,467
D,Colombia,3,3,1,3,-2,D3,467
D,Costa Rica,3,0,1,7,-6,D4,467
A,Canada,3,6,3,3,0,A1,468
A,Argentina,3,4,2,1,1,A2,468
A,Peru,3,4,4,4,0,A3,468
A,Chile,3,2,2,3,-1,A4,468
B,Mexico,3,7,8,1,7,B1,468
B,Ecuador,3,4,1,1,0,B2,468
B,Jamaica,3,4,2,7,-5,B3,468
B,Venezuela,3,1,2,4,-2,B4,468
C,Uruguay,3,9,6,1,5,C1,468
C,United States,3,6,8,4,4,C2,468
C,Panama,3,3,2,4,-2,C3,468
C,Bolivia,3,0,0,7,-7,C4,468
D,Colombia,3,6,4,3,1,D1,468
D,Paraguay,3,4,3,3,0,D2,468
D,Brazil,3,4,2,2,0,D3,468
D,Costa Rica,3,2,1,2,-1,D4,468
A,Argentina,3,9,9,1,8,A1,469
A,Peru,3,6,6,5,1,A2,469
A,Canada,3,3,3,8,-5,A3,469
A,Chile,3,0,4,8,-4,A4,469
B,Mexico,3,7,4,2,2,B1,469
B,Ecuador,3,6,6,2,4,B2,469
B,Jamaica,3,3,3,3,0,B3,469
B,Venezuela,3,1,1,7,-6,B4,469
C,United States,3,5,7,4,3,C1,469
C,Bolivia,3,5,4,2,2,C2,469
C,Uruguay,3,3,0,0,0,C3,469
C,Panama,3,1,2,7,-5,C4,469
D,Brazil,3,7,5,0,5,D1,469
D,Paraguay,3,6,3,3,0,D2,469
D,Colombia,3,4,2,1,1,D3,469
D,Costa Rica,3,0,0,6,-6,D4,469
A,Canada,3,7,6,4,2,A1,470
A,Argentina,3,6,5,4,1,A2,470
A,Chile,3,4,5,5,0,A3,470
A,Peru,3,0,3,6,-3,A4,470
B,Ecuador,3,7,6,2,4,B1,470
B,Venezuela,3,5,4,3,1,B2,470
B,Jamaica,3,2,2,5,-3,B3,470
B,Mexico,3,1,1,3,-2,B4,470
C,Uruguay,3,9,4,0,4,C1,470
C,United States,3,6,4,2,2,C2,470
C,Panama,3,3,3,2,1,C3,470
C,Bolivia,3,0,1,8,-7,C4,470
D,Colombia,3,7,5,2,3,D1,470
D,Brazil,3,5,4,3,1,D2,470
D,Costa Rica,3,4,3,4,-1,D3,470
D,Paraguay,3,0,1,4,-3,D4,470
A,Argentina,3,9,4,1,3,A1,471
A,Peru,3,6,3,2,1,A2,471
A,Canada,3,1,3,5,-2,A3,471
A,Chile,3,1,3,5,-2,A4,471
B,Ecuador,3,6,3,3,0,B1,471
B,Venezuela,3,4,4,3,1,B2,471
B,Mexico,3,4,3,3,0,B3,471
B,Jamaica,3,3,2,3,-1,B4,471
C,Uruguay,3,9,5,1,4,C1,471
C,United States,3,6,5,2,3,C2,471
C,Panama,3,1,1,4,-3,C3,471
C,Bolivia,3,1,1,5,-4,C4,471
D,Brazil,3,9,8,1,7,D1,471
D,Colombia,3,6,5,4,1,D2,471
D,Paraguay,3,3,4,5,-1,D3,471
D,Costa Rica,3,0,2,9,-7,D4,471
A,Canada,3,7,7,2,5,A1,472
A,Chile,3,4,3,4,-1,A2,472
A,Peru,3,3,3,3,0,A3,472
A,Argentina,3,1,3,7,-4,A4,472
B,Ecuador,3,5,4,1,3,B1,472
B,Venezuela,3,5,4,2,2,B2,472
B,Jamaica,3,4,4,5,-1,B3,472
B,Mexico,3,1,2,6,-4,B4,472
C,Uruguay,3,7,6,1,5,C1,472
C,United States,3,7,4,0,4,C2,472
C,Bolivia,3,3,3,5,-2,C3,472
C,Panama,3,0,0,7,-7,C4,472
D,Brazil,3,7,4,1,3,D1,472
D,Paraguay,3,5,5,2,3,D2,472
D,Colombia,3,2,1,3,-2,D3,472
D,Costa Rica,3,1,0,4,-4,D4,472
A,Argentina,3,9,7,2,5,A1,473
A,Peru,3,6,5,3,2,A2,473
A,Chile,3,3,4,5,-1,A3,473
A,Canada,3,0,3,9,-6,A4,473
B,Mexico,3,6,7,2,5,B1,473
B,Ecuador,3,6,7,3,4,B2,473
B,Venezuela,3,6,4,6,-2,B3,473
B,Jamaica,3,0,3,10,-7,B4,473
C,Uruguay,3,9,7,0,7,C1,473
C,United States,3,4,2,4,-2,C2,473
C,Panama,3,3,5,4,1,C3,473
C,Bolivia,3,1,0,6,-6,C4,473
D,Brazil,3,9,7,3,4,D1,473
D,Paraguay,3,4,4,2,2,D2,473
D,Costa Rica,3,4,4,4,0,D3,473
D,Colombia,3,0,3,9,-6,D4,473
A,Argentina,3,5,5,1,4,A1,474
A,Chile,3,5,5,4,1,A2,474
A,Peru,3,3,2,2,0,A3,474
A,Canada,3,1,3,8,-5,A4,474
B,Venezuela,3,6,5,3,2,B1,474
B,Mexico,3,6,5,4,1,B2,474
B,Ecuador,3,4,5,4,1,B3,474
B,Jamaica,3,1,3,7,-4,B4,474
C,United States,3,9,5,0,5,C1,474
C,Uruguay,3,4,2,2,0,C2,474
C,Panama,3,2,3,5,-2,C3,474
C,Bolivia,3,1,2,5,-3,C4,474
D,Brazil,3,5,6,3,3,D1,474
D,Colombia,3,5,2,1,1,D2,474
D,Costa Rica,3,2,1,2,-1,D3,474
D,Paraguay,3,2,3,6,-3,D4,474
A,Argentina,3,9,6,1,5,A1,475
A,Chile,3,6,4,2,2,A2,475
A,Canada,3,3,2,4,-2,A3,475
A,Peru,3,0,3,8,-5,A4,475
B,Ecuador,3,6,3,1,2,B1,475
B,Mexico,3,6,2,1,1,B2,475
B,Venezuela,3,4,3,3,0,B3,475
B,Jamaica,3,1,2,5,-3,B4,475
C,Uruguay,3,7,9,5,4,C1,475
C,United States,3,4,4,3,1,C2,475
C,Bolivia,3,2,3,5,-2,C3,475
C,Panama,3,2,2,5,-3,C4,475
D,Brazil,3,9,4,0,4,D1,475
D,Colombia,3,6,3,1,2,D2,475
D,Paraguay,3,3,3,4,-1,D3,475
D,Costa Rica,3,0,1,6,-5,D4,475
A,Argentina,3,7,3,1,2,A1,476
A,Canada,3,7,3,1,2,A2,476
A,Chile,3,3,4,3,1,A3,476
A,Peru,3,0,1,6,-5,A4,476
B,Mexico,3,7,5,2,3,B1,476
B,Venezuela,3,4,4,3,1,B2,476
B,Jamaica,3,2,2,3,-1,B3,476
B,Ecuador,3,2,1,4,-3,B4,476
C,Uruguay,3,7,6,2,4,C1,476
C,United States,3,7,6,3,3,C2,476
C,Panama,3,3,1,3,-2,C3,476
C,Bolivia,3,0,1,6,-5,C4,476
D,Colombia,3,9,5,0,5,D1,476
D,Brazil,3,6,7,2,5,D2,476
D,Paraguay,3,3,3,5,-2,D3,476
D,Costa Rica,3,0,1,9,-8,D4,476
A,Argentina,3,7,8,1,7,A1,477
A,Canada,3,6,5,6,-1,A2,477
A,Chile,3,2,2,3,-1,A3,477
A,Peru,3,1,1,6,-5,A4,477
B,Mexico,3,7,4,2,2,B1,477
B,Venezuela,3,5,4,3,1,B2,477
B,Ecuador,3,3,6,5,1,B3,477
B,Jamaica,3,1,2,6,-4,B4,477
C,United States,3,7,6,2,4,C1,477
C,Uruguay,3,6,7,6,1,C2,477
C,Panama,3,4,4,4,0,C3,477
C,Bolivia,3,0,1,6,-5,C4,477
D,Paraguay,3,9,4,1,3,D1,477
D,Brazil,3,4,5,3,2,D2,477
D,Colombia,3,4,2,2,0,D3,477
D,Costa Rica,3,0,0,5,-5,D4,477
A,Argentina,3,7,7,1,6,A1,478
A,Chile,3,7,6,2,4,A2,478
A,Canada,3,3,2,5,-3,A3,478
A,Peru,3,0,0,7,-7,A4,478
B,Mexico,3,6,6,4,2,B1,478
B,Ecuador,3,6,3,2,1,B2,478
B,Venezuela,3,3,5,5,0,B3,478
B,Jamaica,3,3,3,6,-3,B4,478
C,United States,3,7,4,1,3,C1,478
C,Bolivia,3,4,4,4,0,C2,478
C,Panama,3,3,4,5,-1,C3,478
C,Uruguay,3,3,2,4,-2,C4,478
D,Paraguay,3,9,5,1,4,D1,478
D,Brazil,3,4,4,4,0,D2,478
D,Colombia,3,3,3,5,-2,D3,478
D,Costa Rica,3,1,2,4,-2,D4,478
A,Argentina,3,7,7,3,4,A1,479
A,Canada,3,6,4,3,1,A2,479
A,Peru,3,4,5,6,-1,A3,479
A,Chile,3,0,2,6,-4,A4,479
B,Mexico,3,5,3,1,2,B1,479
B,Venezuela,3,5,2,0,2,B2,479
B,Ecuador,3,3,1,1,0,B3,479
B,Jamaica,3,1,2,6,-4,B4,479
C,United States,3,7,4,1,3,C1,479
C,Uruguay,3,6,6,2,4,C2,479
C,Panama,3,4,3,4,-1,C3,479
C,Bolivia,3,0,2,8,-6,C4,479
D,Brazil,3,9,10,1,9,D1,479
D,Colombia,3,6,7,6,1,D2,479
D,Paraguay,3,3,4,7,-3,D3,479
D,Costa Rica,3,0,1,8,-7,D4,479
A,Argentina,3,7,7,2,5,A1,480
A,Peru,3,4,5,5,0,A2,480
A,Canada,3,3,2,3,-1,A3,480
A,Chile,3,3,4,8,-4,A4,480
B,Jamaica,3,7,4,1,3,B1,480
B,Mexico,3,4,1,2,-1,B2,480
B,Venezuela,3,3,1,2,-1,B3,480
B,Ecuador,3,2,1,2,-1,B4,480
C,Bolivia,3,7,5,2,3,C1,480
C,Uruguay,3,5,4,2,2,C2,480
C,United States,3,3,5,5,0,C3,480
C,Panama,3,1,3,8,-5,C4,480
D,Colombia,3,9,7,1,6,D1,480
D,Brazil,3,6,5,2,3,D2,480
D,Costa Rica,3,3,1,4,-3,D3,480
D,Paraguay,3,0,1,7,-6,D4,480
A,Chile,3,6,4,7,-3,A1,481
A,Canada,3,4,9,5,4,A2,481
A,Peru,3,4,4,4,0,A3,481
A,Argentina,3,2,3,4,-1,A4,481
B,Ecuador,3,7,5,2,3,B1,481
B,Venezuela,3,6,8,5,3,B2,481
B,Mexico,3,3,6,6,0,B3,481
B,Jamaica,3,1,2,8,-6,B4,481
C,United States,3,6,4,3,1,C1,481
C,Uruguay,3,4,5,3,2,C2,481
C,Bolivia,3,4,3,3,0,C3,481
C,Panama,3,3,3,6,-3,C4,481
D,Brazil,3,9,6,1,5,D1,481
D,Paraguay,3,4,3,3,0,D2,481
D,Colombia,3,2,1,2,-1,D3,481
D,Costa Rica,3,1,1,5,-4,D4,481
A,Argentina,3,9,4,1,3,A1,482
A,Peru,3,4,2,2,0,A2,482
A,Chile,3,2,1,2,-1,A3,482
A,Canada,3,1,3,5,-2,A4,482
B,Ecuador,3,5,3,2,1,B1,482
B,Jamaica,3,4,4,4,0,B2,482
B,Venezuela,3,4,3,3,0,B3,482
B,Mexico,3,3,2,3,-1,B4,482
C,Uruguay,3,6,5,3,2,C1,482
C,United States,3,5,6,4,2,C2,482
C,Bolivia,3,2,3,4,-1,C3,482
C,Panama,3,2,4,7,-3,C4,482
D,Brazil,3,6,6,2,4,D1,482
D,Colombia,3,4,5,3,2,D2,482
D,Costa Rica,3,4,4,6,-2,D3,482
D,Paraguay,3,2,2,6,-4,D4,482
A,Argentina,3,7,8,5,3,A1,483
A,Canada,3,4,4,4,0,A2,483
A,Chile,3,2,2,3,-1,A3,483
A,Peru,3,2,3,5,-2,A4,483
B,Mexico,3,5,6,4,2,B1,483
B,Jamaica,3,5,5,4,1,B2,483
B,Venezuela,3,3,4,6,-2,B3,483
B,Ecuador,3,2,3,4,-1,B4,483
C,United States,3,7,7,3,4,C1,483
C,Uruguay,3,4,5,2,3,C2,483
C,Bolivia,3,4,4,6,-2,C3,483
C,Panama,3,1,2,7,-5,C4,483
D,Colombia,3,7,7,1,6,D1,483
D,Brazil,3,6,7,2,5,D2,483
D,Paraguay,3,3,3,9,-6,D3,483
D,Costa Rica,3,1,3,8,-5,D4,483
A,Argentina,3,5,3,2,1,A1,484
A,Canada,3,4,2,2,0,A2,484
A,Peru,3,3,1,1,0,A3,484
A,Chile,3,2,4,5,-1,A4,484
B,Ecuador,3,5,5,3,2,B1,484
B,Mexico,3,5,6,5,1,B2,484
B,Jamaica,3,4,3,4,-1,B3,484
B,Venezuela,3,1,4,6,-2,B4,484
C,Uruguay,3,6,6,4,2,C1,484
C,United States,3,4,7,5,2,C2,484
C,Bolivia,3,4,4,4,0,C3,484
C,Panama,3,3,4,8,-4,C4,484
D,Brazil,3,9,6,1,5,D1,484
D,Colombia,3,4,4,3,1,D2,484
D,Paraguay,3,4,4,3,1,D3,484
D,Costa Rica,3,0,2,9,-7,D4,484
A,Argentina,3,9,9,1,8,A1,485
A,Chile,3,4,3,4,-1,A2,485
A,Canada,3,3,3,6,-3,A3,485
A,Peru,3,1,1,5,-4,A4,485
B,Mexico,3,7,3,1,2,B1,485
B,Jamaica,3,4,5,5,0,B2,485
B,Venezuela,3,4,3,3,0,B3,485
B,Ecuador,3,1,5,7,-2,B4,485
C,United States,3,9,4,0,4,C1,485
C,Uruguay,3,4,6,2,4,C2,485
C,Panama,3,4,4,2,2,C3,485
C,Bolivia,3,0,0,10,-10,C4,485
D,Costa Rica,3,7,4,2,2,D1,485
D,Paraguay,3,6,4,2,2,D2,485
D,Brazil,3,3,3,5,-2,D3,485
D,Colombia,3,1,3,5,-2,D4,485
A,Argentina,3,9,6,0,6,A1,486
A,Peru,3,4,1,1,0,A2,486
A,Chile,3,2,0,3,-3,A3,486
A,Canada,3,1,0,3,-3,A4,486
B,Mexico,3,9,7,1,6,B1,486
B,Jamaica,3,6,6,2,4,B2,486
B,Ecuador,3,3,1,6,-5,B3,486
B,Venezuela,3,0,0,5,-5,B4,486
C,Uruguay,3,9,8,2,6,C1,486
C,United States,3,6,4,3,1,C2,486
C,Panama,3,3,2,3,-1,C3,486
C,Bolivia,3,0,2,8,-6,C4,486
D,Brazil,3,7,5,2,3,D1,486
D,Paraguay,3,6,4,2,2,D2,486
D,Costa Rica,3,3,4,6,-2,D3,486
D,Colombia,3,1,1,4,-3,D4,486
A,Argentina,3,9,10,3,7,A1,487
A,Canada,3,4,3,4,-1,A2,487
A,Chile,3,3,4,7,-3,A3,487
A,Peru,3,1,2,5,-3,A4,487
B,Ecuador,3,5,2,0,2,B1,487
B,Venezuela,3,5,3,2,1,B2,487
B,Mexico,3,3,1,1,0,B3,487
B,Jamaica,3,1,1,4,-3,B4,487
C,United States,3,7,6,1,5,C1,487
C,Panama,3,4,4,6,-2,C2,487
C,Uruguay,3,3,2,2,0,C3,487
C,Bolivia,3,1,3,6,-3,C4,487
D,Colombia,3,9,4,0,4,D1,487
D,Brazil,3,6,5,1,4,D2,487
D,Costa Rica,3,1,1,4,-3,D3,487
D,Paraguay,3,1,1,6,-5,D4,487
A,Argentina,3,7,11,6,5,A1,488
A,Canada,3,4,6,7,-1,A2,488
A,Chile,3,3,6,8,-2,A3,488
A,Peru,3,2,4,6,-2,A4,488
B,Mexico,3,9,5,2,3,B1,488
B,Ecuador,3,4,6,2,4,B2,488
B,Venezuela,3,4,2,1,1,B3,488
B,Jamaica,3,0,1,9,-8,B4,488
C,United States,3,5,6,3,3,C1,488
C,Bolivia,3,4,3,3,0,C2,488
C,Uruguay,3,4,2,4,-2,C3,488
C,Panama,3,2,2,3,-1,C4,488
D,Brazil,3,7,4,1,3,D1,488
D,Colombia,3,6,5,1,4,D2,488
D,Costa Rica,3,3,3,7,-4,D3,488
D,Paraguay,3,1,1,4,-3,D4,488
A,Argentina,3,9,7,2,5,A1,489
A,Chile,3,3,3,4,-1,A2,489
A,Canada,3,3,2,3,-1,A3,489
A,Peru,3,3,4,7,-3,A4,489
B,Ecuador,3,5,2,1,1,B1,489
B,Mexico,3,5,1,0,1,B2,489
B,Jamaica,3,4,4,2,2,B3,489
B,Venezuela,3,1,0,4,-4,B4,489
C,Uruguay,3,7,6,2,4,C1,489
C,Panama,3,4,2,2,0,C2,489
C,Bolivia,3,3,3,6,-3,C3,489
C,United States,3,2,4,5,-1,C4,489
D,Brazil,3,9,8,0,8,D1,489
D,Colombia,3,4,1,1,0,D2,489
D,Costa Rica,3,4,2,3,-1,D3,489
D,Paraguay,3,0,0,7,-7,D4,489
A,Argentina,3,7,6,2,4,A1,490
A,Chile,3,4,3,4,-1,A2,490
A,Peru,3,3,5,6,-1,A3,490
A,Canada,3,3,5,7,-2,A4,490
B,Venezuela,3,7,4,2,2,B1,490
B,Jamaica,3,4,2,2,0,B2,490
B,Mexico,3,3,2,3,-1,B3,490
B,Ecuador,3,2,2,3,-1,B4,490
C,Bolivia,3,7,5,3,2,C1,490
C,United States,3,5,2,1,1,C2,490
C,Panama,3,2,2,3,-1,C3,490
C,Uruguay,3,1,2,4,-2,C4,490
D,Brazil,3,9,6,0,6,D1,490
D,Costa Rica,3,6,4,2,2,D2,490
D,Colombia,3,3,1,4,-3,D3,490
D,Paraguay,3,0,1,6,-5,D4,490
A,Argentina,3,7,8,0,8,A1,491
A,Peru,3,7,6,3,3,A2,491
A,Chile,3,1,4,9,-5,A3,491
A,Canada,3,1,3,9,-6,A4,491
B,Venezuela,3,7,4,2,2,B1,491
B,Mexico,3,5,6,4,2,B2,491
B,Ecuador,3,2,3,4,-1,B3,491
B,Jamaica,3,1,1,4,-3,B4,491
C,Uruguay,3,9,9,2,7,C1,491
C,United States,3,4,4,4,0,C2,491
C,Panama,3,2,2,4,-2,C3,491
C,Bolivia,3,1,1,6,-5,C4,491
D,Paraguay,3,9,6,2,4,D1,491
D,Brazil,3,6,8,3,5,D2,491
D,Colombia,3,3,5,5,0,D3,491
D,Costa Rica,3,0,1,10,-9,D4,491
A,Argentina,3,7,9,3,6,A1,492
A,Chile,3,5,3,2,1,A2,492
A,Canada,3,4,2,3,-1,A3,492
A,Peru,3,0,0,6,-6,A4,492
B,Mexico,3,7,6,3,3,B1,492
B,Jamaica,3,4,3,5,-2,B2,492
B,Venezuela,3,3,4,4,0,B3,492
B,Ecuador,3,3,4,5,-1,B4,492
C,United States,3,9,6,0,6,C1,492
C,Uruguay,3,4,3,3,0,C2,492
C,Bolivia,3,4,3,4,-1,C3,492
C,Panama,3,0,2,7,-5,C4,492
D,Brazil,3,7,4,1,3,D1,492
D,Colombia,3,4,5,3,2,D2,492
D,Costa Rica,3,4,1,3,-2,D3,492
D,Paraguay,3,1,1,4,-3,D4,492
A,Argentina,3,7,7,2,5,A1,493
A,Peru,3,4,4,5,-1,A2,493
A,Canada,3,3,3,4,-1,A3,493
A,Chile,3,3,4,7,-3,A4,493
B,Mexico,3,7,8,3,5,B1,493
B,Ecuador,3,6,5,4,1,B2,493
B,Venezuela,3,4,5,5,0,B3,493
B,Jamaica,3,0,1,7,-6,B4,493
C,Bolivia,3,7,3,1,2,C1,493
C,United States,3,6,5,2,3,C2,493
C,Uruguay,3,2,2,4,-2,C3,493
C,Panama,3,1,0,3,-3,C4,493
D,Brazil,3,6,5,3,2,D1,493
D,Colombia,3,6,5,5,0,D2,493
D,Paraguay,3,3,6,6,0,D3,493
D,Costa Rica,3,3,3,5,-2,D4,493
A,Peru,3,6,4,2,2,A1,494
A,Chile,3,6,3,2,1,A2,494
A,Canada,3,3,2,3,-1,A3,494
A,Argentina,3,3,2,4,-2,A4,494
B,Venezuela,3,7,6,2,4,B1,494
B,Ecuador,3,4,4,4,0,B2,494
B,Jamaica,3,2,5,7,-2,B3,494
B,Mexico,3,2,3,5,-2,B4,494
C,Uruguay,3,7,5,0,5,C1,494
C,United States,3,6,6,3,3,C2,494
C,Bolivia,3,2,2,3,-1,C3,494
C,Panama,3,1,0,7,-7,C4,494
D,Brazil,3,9,6,2,4,D1,494
D,Colombia,3,4,3,3,0,D2,494
D,Costa Rica,3,2,2,4,-2,D3,494
D,Paraguay,3,1,0,2,-2,D4,494
A,Argentina,3,9,5,1,4,A1,495
A,Chile,3,4,4,3,1,A2,495
A,Canada,3,3,4,5,-1,A3,495
A,Peru,3,1,1,5,-4,A4,495
B,Ecuador,3,7,5,2,3,B1,495
B,Jamaica,3,4,4,3,1,B2,495
B,Venezuela,3,3,1,1,0,B3,495
B,Mexico,3,1,1,5,-4,B4,495
C,Panama,3,9,4,1,3,C1,495
C,Uruguay,3,4,3,1,2,C2,495
C,United States,3,4,2,1,1,C3,495
C,Bolivia,3,0,1,7,-6,C4,495
D,Colombia,3,7,4,1,3,D1,495
D,Brazil,3,4,4,3,1,D2,495
D,Costa Rica,3,3,2,2,0,D3,495
D,Paraguay,3,1,3,7,-4,D4,495
A,Argentina,3,7,3,1,2,A1,496
A,Chile,3,3,4,4,0,A2,496
A,Peru,3,2,2,3,-1,A3,496
A,Canada,3,2,1,2,-1,A4,496
B,Ecuador,3,7,7,1,6,B1,496
B,Jamaica,3,6,2,2,0,B2,496
B,Venezuela,3,3,3,6,-3,B3,496
B,Mexico,3,1,2,5,-3,B4,496
C,United States,3,9,6,1,5,C1,496
C,Uruguay,3,3,4,3,1,C2,496
C,Panama,3,3,2,3,-1,C3,496
C,Bolivia,3,3,2,7,-5,C4,496
D,Brazil,3,7,4,2,2,D1,496
D,Paraguay,3,6,7,5,2,D2,496
D,Colombia,3,4,5,1,4,D3,496
D,Costa Rica,3,0,2,10,-8,D4,496
A,Argentina,3,7,5,0,5,A1,497
A,Chile,3,5,5,2,3,A2,497
A,Peru,3,4,3,3,0,A3,497
A,Canada,3,0,0,8,-8,A4,497
B,Ecuador,3,7,3,1,2,B1,497
B,Venezuela,3,6,3,2,1,B2,497
B,Mexico,3,3,3,2,1,B3,497
B,Jamaica,3,1,0,4,-4,B4,497
C,Uruguay,3,6,7,7,0,C1,497
C,Panama,3,5,5,1,4,C2,497
C,United States,3,4,4,3,1,C3,497
C,Bolivia,3,1,2,7,-5,C4,497
D,Colombia,3,6,5,4,1,D1,497
D,Brazil,3,5,3,2,1,D2,497
D,Paraguay,3,4,5,5,0,D3,497
D,Costa Rica,3,1,1,3,-2,D4,497
A,Argentina,3,9,4,0,4,A1,498
A,Chile,3,6,5,2,3,A2,498
A,Peru,3,1,0,2,-2,A3,498
A,Canada,3,1,1,6,-5,A4,498
B,Mexico,3,9,5,0,5,B1,498
B,Jamaica,3,2,3,4,-1,B2,498
B,Ecuador,3,2,3,5,-2,B3,498
B,Venezuela,3,2,2,4,-2,B4,498
C,Uruguay,3,7,4,1,3,C1,498
C,United States,3,5,3,0,3,C2,498
C,Panama,3,3,2,5,-3,C3,498
C,Bolivia,3,1,1,4,-3,C4,498
D,Brazil,3,7,8,4,4,D1,498
D,Costa Rica,3,6,3,4,-1,D2,498
D,Colombia,3,4,2,2,0,D3,498
D,Paraguay,3,0,2,5,-3,D4,498
A,Chile,3,7,6,2,4,A1,499
A,Argentina,3,5,4,3,1,A2,499
A,Canada,3,3,3,2,1,A3,499
A,Peru,3,1,1,7,-6,A4,499
B,Venezuela,3,6,5,3,2,B1,499
B,Mexico,3,4,4,4,0,B2,499
B,Ecuador,3,4,3,3,0,B3,499
B,Jamaica,3,3,4,6,-2,B4,499
C,United States,3,9,8,0,8,C1,499
C,Uruguay,3,2,0,1,-1,C2,499
C,Bolivia,3,2,1,3,-2,C3,499
C,Panama,3,2,1,6,-5,C4,499
D,Colombia,3,5,4,1,3,D1,499
D,Brazil,3,5,4,2,2,D2,499
D,Costa Rica,3,5,3,1,2,D3,499
D,Paraguay,3,0,0,7,-7,D4,499
A,Argentina,3,7,3,1,2,A1,500
A,Peru,3,4,5,4,1,A2,500
A,Chile,3,3,3,4,-1,A3,500
A,Canada,3,2,1,3,-2,A4,500
B,Mexico,3,9,9,1,8,B1,500
B,Ecuador,3,4,4,3,1,B2,500
B,Venezuela,3,3,3,9,-6,B3,500
B,Jamaica,3,1,3,6,-3,B4,500
C,United States,3,9,9,0,9,C1,500
C,Uruguay,3,6,4,2,2,C2,500
C,Bolivia,3,3,2,7,-5,C3,500
C,Panama,3,0,0,6,-6,C4,500
D,Brazil,3,6,7,3,4,D1,500
D,Paraguay,3,4,3,2,1,D2,500
D,Colombia,3,4,4,5,-1,D3,500
D,Costa Rica,3,2,4,8,-4,D4,500
A,Chile,3,7,5,3,2,A1,501
A,Argentina,3,6,5,3,2,A2,501
A,Peru,3,3,3,3,0,A3,501
A,Canada,3,1,2,6,-4,A4,501
B,Mexico,3,7,6,3,3,B1,501
B,Jamaica,3,6,7,4,3,B2,501
B,Ecuador,3,2,3,6,-3,B3,501
B,Venezuela,3,1,3,6,-3,B4,501
C,United States,3,9,7,0,7,C1,501
C,Uruguay,3,4,3,3,0,C2,501
C,Panama,3,4,3,6,-3,C3,501
C,Bolivia,3,0,2,6,-4,C4,501
D,Brazil,3,9,9,2,7,D1,501
D,Colombia,3,6,5,2,3,D2,501
D,Paraguay,3,3,3,5,-2,D3,501
D,Costa Rica,3,0,1,9,-8,D4,501
A,Argentina,3,9,8,1,7,A1,502
A,Peru,3,4,3,3,0,A2,502
A,Canada,3,3,1,4,-3,A3,502
A,Chile,3,1,1,5,-4,A4,502
B,Mexico,3,9,6,0,6,B1,502
B,Jamaica,3,6,4,3,1,B2,502
B,Venezuela,3,1,0,3,-3,B3,502
B,Ecuador,3,1,0,4,-4,B4,502
C,Uruguay,3,5,4,1,3,C1,502
C,United States,3,5,3,2,1,C2,502
C,Panama,3,3,6,6,0,C3,502
C,Bolivia,3,1,3,7,-4,C4,502
D,Brazil,3,4,2,2,0,D1,502
D,Colombia,3,4,2,2,0,D2,502
D,Paraguay,3,4,1,1,0,D3,502
D,Costa Rica,3,3,2,2,0,D4,502
A,Argentina,3,9,4,0,4,A1,503
A,Peru,3,4,5,6,-1,A2,503
A,Canada,3,2,4,5,-1,A3,503
A,Chile,3,1,2,4,-2,A4,503
B,Mexico,3,5,3,1,2,B1,503
B,Ecuador,3,4,4,4,0,B2,503
B,Jamaica,3,3,2,2,0,B3,503
B,Venezuela,3,2,1,3,-2,B4,503
C,United States,3,9,8,2,6,C1,503
C,Uruguay,3,6,7,4,3,C2,503
C,Bolivia,3,1,4,8,-4,C3,503
C,Panama,3,1,2,7,-5,C4,503
D,Brazil,3,7,2,0,2,D1,503
D,Colombia,3,4,3,4,-1,D2,503
D,Costa Rica,3,3,3,2,1,D3,503
D,Paraguay,3,3,2,4,-2,D4,503
A,Argentina,3,7,4,1,3,A1,504
A,Peru,3,5,5,4,1,A2,504
A,Chile,3,4,3,3,0,A3,504
A,Canada,3,0,1,5,-4,A4,504
B,Ecuador,3,5,5,4,1,B1,504
B,Mexico,3,5,4,3,1,B2,504
B,Venezuela,3,3,2,3,-1,B3,504
B,Jamaica,3,2,4,5,-1,B4,504
C,United States,3,9,10,2,8,C1,504
C,Bolivia,3,4,2,5,-3,C2,504
C,Panama,3,2,1,2,-1,C3,504
C,Uruguay,3,1,3,7,-4,C4,504
D,Brazil,3,7,7,3,4,D1,504
D,Colombia,3,5,2,1,1,D2,504
D,Paraguay,3,3,2,2,0,D3,504
D,Costa Rica,3,1,2,7,-5,D4,504
A,Argentina,3,7,7,1,6,A1,505
A,Peru,3,6,3,2,1,A2,505
A,Chile,3,4,3,3,0,A3,505
A,Canada,3,0,2,9,-7,A4,505
B,Ecuador,3,5,2,1,1,B1,505
B,Jamaica,3,4,2,1,1,B2,505
B,Venezuela,3,4,2,3,-1,B3,505
B,Mexico,3,3,1,2,-1,B4,505
C,Bolivia,3,7,6,3,3,C1,505
C,United States,3,6,7,5,2,C2,505
C,Uruguay,3,4,2,2,0,C3,505
C,Panama,3,0,2,7,-5,C4,505
D,Brazil,3,9,11,2,9,D1,505
D,Colombia,3,6,4,4,0,D2,505
D,Paraguay,3,3,2,5,-3,D3,505
D,Costa Rica,3,0,1,7,-6,D4,505
A,Argentina,3,7,6,1,5,A1,506
A,Peru,3,6,6,5,1,A2,506
A,Chile,3,2,4,5,-1,A3,506
A,Canada,3,1,2,7,-5,A4,506
B,Mexico,3,9,12,1,11,B1,506
B,Ecuador,3,4,3,4,-1,B2,506
B,Venezuela,3,4,4,6,-2,B3,506
B,Jamaica,3,0,1,9,-8,B4,506
C,United States,3,7,3,1,2,C1,506
C,Uruguay,3,4,4,1,3,C2,506
C,Panama,3,3,3,7,-4,C3,506
C,Bolivia,3,2,1,2,-1,C4,506
D,Brazil,3,5,5,2,3,D1,506
D,Colombia,3,5,3,2,1,D2,506
D,Costa Rica,3,2,2,3,-1,D3,506
D,Paraguay,3,2,2,5,-3,D4,506
A,Peru,3,9,5,2,3,A1,507
A,Argentina,3,6,5,3,2,A2,507
A,Chile,3,1,6,8,-2,A3,507
A,Canada,3,1,2,5,-3,A4,507
B,Mexico,3,6,3,2,1,B1,507
B,Ecuador,3,4,3,2,1,B2,507
B,Venezuela,3,4,3,3,0,B3,507
B,Jamaica,3,3,3,5,-2,B4,507
C,Uruguay,3,7,5,0,5,C1,507
C,Panama,3,4,2,3,-1,C2,507
C,Bolivia,3,3,2,5,-3,C3,507
C,United States,3,2,2,3,-1,C4,507
D,Colombia,3,9,3,0,3,D1,507
D,Brazil,3,6,9,1,8,D2,507
D,Paraguay,3,3,2,7,-5,D3,507
D,Costa Rica,3,0,1,7,-6,D4,507
A,Chile,3,6,3,2,1,A1,508
A,Canada,3,4,2,2,0,A2,508
A,Peru,3,4,1,1,0,A3,508
A,Argentina,3,2,2,3,-1,A4,508
B,Ecuador,3,9,8,1,7,B1,508
B,Mexico,3,3,2,2,0,B2,508
B,Venezuela,3,3,1,3,-2,B3,508
B,Jamaica,3,3,2,7,-5,B4,508
C,Uruguay,3,7,7,1,6,C1,508
C,United States,3,6,5,4,1,C2,508
C,Panama,3,2,1,2,-1,C3,508
C,Bolivia,3,1,1,7,-6,C4,508
D,Brazil,3,9,6,1,5,D1,508
D,Colombia,3,4,3,3,0,D2,508
D,Costa Rica,3,2,2,3,-1,D3,508
D,Paraguay,3,1,1,5,-4,D4,508
A,Argentina,3,9,10,1,9,A1,509
A,Chile,3,4,4,2,2,A2,509
A,Canada,3,4,3,4,-1,A3,509
A,Peru,3,0,0,10,-10,A4,509
B,Jamaica,3,9,6,2,4,B1,509
B,Venezuela,3,6,5,3,2,B2,509
B,Mexico,3,3,4,6,-2,B3,509
B,Ecuador,3,0,3,7,-4,B4,509
C,Uruguay,3,7,5,1,4,C1,509
C,United States,3,6,9,4,5,C2,509
C,Panama,3,3,3,8,-5,C3,509
C,Bolivia,3,1,4,8,-4,C4,509
D,Colombia,3,7,2,0,2,D1,509
D,Brazil,3,4,1,1,0,D2,509
D,Costa Rica,3,4,1,1,0,D3,509
D,Paraguay,3,1,0,2,-2,D4,509
A,Argentina,3,6,5,4,1,A1,510
A,Chile,3,4,3,3,0,A2,510
A,Peru,3,4,2,2,0,A3,510
A,Canada,3,3,2,3,-1,A4,510
B,Mexico,3,6,6,4,2,B1,510
B,Ecuador,3,4,3,3,0,B2,510
B,Jamaica,3,4,3,3,0,B3,510
B,Venezuela,3,3,3,5,-2,B4,510
C,United States,3,5,7,5,2,C1,510
C,Uruguay,3,5,7,5,2,C2,510
C,Bolivia,3,3,6,6,0,C3,510
C,Panama,3,1,6,10,-4,C4,510
D,Brazil,3,9,8,1,7,D1,510
D,Colombia,3,6,5,5,0,D2,510
D,Costa Rica,3,3,4,8,-4,D3,510
D,Paraguay,3,0,1,4,-3,D4,510
A,Argentina,3,9,9,3,6,A1,511
A,Chile,3,6,7,6,1,A2,511
A,Canada,3,1,2,4,-2,A3,511
A,Peru,3,1,1,6,-5,A4,511
B,Ecuador,3,9,7,2,5,B1,511
B,Mexico,3,4,4,3,1,B2,511
B,Jamaica,3,3,2,5,-3,B3,511
B,Venezuela,3,1,2,5,-3,B4,511
C,Uruguay,3,9,13,2,11,C1,511
C,United States,3,2,1,2,-1,C2,511
C,Bolivia,3,2,2,5,-3,C3,511
C,Panama,3,2,1,8,-7,C4,511
D,Brazil,3,7,9,2,7,D1,511
D,Colombia,3,4,2,2,0,D2,511
D,Paraguay,3,2,2,3,-1,D3,511
D,Costa Rica,3,2,1,7,-6,D4,511
A,Argentina,3,7,6,1,5,A1,512
A,Chile,3,4,2,3,-1,A2,512
A,Peru,3,2,2,3,-1,A3,512
A,Canada,3,2,2,5,-3,A4,512
B,Venezuela,3,9,8,1,7,B1,512
B,Mexico,3,4,3,4,-1,B2,512
B,Ecuador,3,3,2,4,-2,B3,512
B,Jamaica,3,1,0,4,-4,B4,512
C,United States,3,7,9,2,7,C1,512
C,Bolivia,3,6,3,7,-4,C2,512
C,Uruguay,3,3,6,4,2,C3,512
C,Panama,3,1,1,6,-5,C4,512
D,Brazil,3,6,6,3,3,D1,512
D,Costa Rica,3,4,2,1,1,D2,512
D,Colombia,3,4,2,5,-3,D3,512
D,Paraguay,3,2,2,3,-1,D4,512
A,Argentina,3,6,7,2,5,A1,513
A,Peru,3,6,4,3,1,A2,513
A,Canada,3,3,2,4,-2,A3,513
A,Chile,3,3,1,5,-4,A4,513
B,Mexico,3,9,8,1,7,B1,513
B,Venezuela,3,4,4,3,1,B2,513
B,Ecuador,3,4,5,8,-3,B3,513
B,Jamaica,3,0,3,8,-5,B4,513
C,United States,3,7,4,2,2,C1,513
C,Uruguay,3,4,3,1,2,C2,513
C,Panama,3,2,2,3,-1,C3,513
C,Bolivia,3,2,2,5,-3,C4,513
D,Brazil,3,7,3,1,2,D1,513
D,Colombia,3,4,4,3,1,D2,513
D,Paraguay,3,2,2,3,-1,D3,513
D,Costa Rica,3,2,1,3,-2,D4,513
A,Argentina,3,7,4,1,3,A1,514
A,Chile,3,6,5,2,3,A2,514
A,Peru,3,4,3,3,0,A3,514
A,Canada,3,0,0,6,-6,A4,514
B,Mexico,3,7,7,1,6,B1,514
B,Ecuador,3,6,4,5,-1,B2,514
B,Venezuela,3,2,0,1,-1,B3,514
B,Jamaica,3,1,1,5,-4,B4,514
C,United States,3,9,6,0,6,C1,514
C,Uruguay,3,6,5,2,3,C2,514
C,Bolivia,3,1,0,4,-4,C3,514
C,Panama,3,1,1,6,-5,C4,514
D,Brazil,3,7,10,1,9,D1,514
D,Colombia,3,5,1,0,1,D2,514
D,Costa Rica,3,2,1,6,-5,D3,514
D,Paraguay,3,1,2,7,-5,D4,514
A,Argentina,3,7,3,0,3,A1,515
A,Canada,3,4,3,2,1,A2,515
A,Peru,3,3,3,3,0,A3,515
A,Chile,3,3,2,6,-4,A4,515
B,Ecuador,3,6,4,2,2,B1,515
B,Jamaica,3,6,4,4,0,B2,515
B,Mexico,3,3,4,5,-1,B3,515
B,Venezuela,3,3,3,4,-1,B4,515
C,United States,3,5,5,2,3,C1,515
C,Uruguay,3,5,5,4,1,C2,515
C,Bolivia,3,4,4,3,1,C3,515
C,Panama,3,1,2,7,-5,C4,515
D,Colombia,3,9,5,1,4,D1,515
D,Brazil,3,6,5,3,2,D2,515
D,Costa Rica,3,1,1,3,-2,D3,515
D,Paraguay,3,1,2,6,-4,D4,515
A,Argentina,3,6,7,3,4,A1,516
A,Chile,3,6,3,4,-1,A2,516
A,Peru,3,4,3,3,0,A3,516
A,Canada,3,1,1,4,-3,A4,516
B,Venezuela,3,6,2,3,-1,B1,516
B,Ecuador,3,5,5,2,3,B2,516
B,Mexico,3,4,4,2,2,B3,516
B,Jamaica,3,1,1,5,-4,B4,516
C,United States,3,9,9,3,6,C1,516
C,Panama,3,4,3,3,0,C2,516
C,Uruguay,3,3,2,4,-2,C3,516
C,Bolivia,3,1,4,8,-4,C4,516
D,Colombia,3,5,1,0,1,D1,516
D,Costa Rica,3,4,6,3,3,D2,516
D,Paraguay,3,3,1,1,0,D3,516
D,Brazil,3,2,1,5,-4,D4,516
A,Argentina,3,9,10,2,8,A1,517
A,Chile,3,4,4,5,-1,A2,517
A,Peru,3,2,5,7,-2,A3,517
A,Canada,3,1,6,11,-5,A4,517
B,Ecuador,3,7,7,2,5,B1,517
B,Jamaica,3,4,3,4,-1,B2,517
B,Mexico,3,4,2,3,-1,B3,517
B,Venezuela,3,1,0,3,-3,B4,517
C,United States,3,7,6,2,4,C1,517
C,Uruguay,3,4,3,5,-2,C2,517
C,Bolivia,3,3,3,3,0,C3,517
C,Panama,3,1,3,5,-2,C4,517
D,Brazil,3,9,6,0,6,D1,517
D,Colombia,3,3,2,3,-1,D2,517
D,Paraguay,3,3,4,6,-2,D3,517
D,Costa Rica,3,3,2,5,-3,D4,517
A,Argentina,3,5,7,3,4,A1,518
A,Canada,3,5,4,3,1,A2,518
A,Chile,3,3,2,6,-4,A3,518
A,Peru,3,2,1,2,-1,A4,518
B,Mexico,3,5,9,4,5,B1,518
B,Ecuador,3,5,6,3,3,B2,518
B,Jamaica,3,4,3,5,-2,B3,518
B,Venezuela,3,1,1,7,-6,B4,518
C,United States,3,7,4,1,3,C1,518
C,Uruguay,3,5,4,2,2,C2,518
C,Panama,3,3,4,4,0,C3,518
C,Bolivia,3,1,2,7,-5,C4,518
D,Brazil,3,9,8,1,7,D1,518
D,Colombia,3,6,5,6,-1,D2,518
D,Paraguay,3,3,4,6,-2,D3,518
D,Costa Rica,3,0,1,5,-4,D4,518
A,Chile,3,7,5,1,4,A1,519
A,Argentina,3,5,5,3,2,A2,519
A,Canada,3,3,1,4,-3,A3,519
A,Peru,3,1,2,5,-3,A4,519
B,Ecuador,3,7,8,3,5,B1,519
B,Mexico,3,4,3,3,0,B2,519
B,Venezuela,3,2,4,6,-2,B3,519
B,Jamaica,3,2,2,5,-3,B4,519
C,Uruguay,3,7,5,1,4,C1,519
C,United States,3,4,2,2,0,C2,519
C,Bolivia,3,3,1,3,-2,C3,519
C,Panama,3,3,1,3,-2,C4,519
D,Brazil,3,9,10,1,9,D1,519
D,Costa Rica,3,6,4,5,-1,D2,519
D,Colombia,3,3,3,5,-2,D3,519
D,Paraguay,3,0,3,9,-6,D4,519
A,Chile,3,9,7,1,6,A1,520
A,Argentina,3,6,8,4,4,A2,520
A,Peru,3,3,3,7,-4,A3,520
A,Canada,3,0,4,10,-6,A4,520
B,Mexico,3,6,9,6,3,B1,520
B,Ecuador,3,6,6,7,-1,B2,520
B,Venezuela,3,3,4,5,-1,B3,520
B,Jamaica,3,3,2,3,-1,B4,520
C,United States,3,6,5,3,2,C1,520
C,Bolivia,3,6,4,3,1,C2,520
C,Uruguay,3,6,4,3,1,C3,520
C,Panama,3,0,0,4,-4,C4,520
D,Brazil,3,7,9,4,5,D1,520
D,Paraguay,3,4,5,6,-1,D2,520
D,Costa Rica,3,2,3,4,-1,D3,520
D,Colombia,3,2,1,4,-3,D4,520
A,Argentina,3,9,13,0,13,A1,521
A,Peru,3,6,2,6,-4,A2,521
A,Chile,3,3,1,4,-3,A3,521
A,Canada,3,0,0,6,-6,A4,521
B,Mexico,3,7,5,1,4,B1,521
B,Venezuela,3,6,3,3,0,B2,521
B,Ecuador,3,2,2,3,-1,B3,521
B,Jamaica,3,1,2,5,-3,B4,521
C,United States,3,7,6,0,6,C1,521
C,Uruguay,3,6,4,3,1,C2,521
C,Bolivia,3,4,3,3,0,C3,521
C,Panama,3,0,2,9,-7,C4,521
D,Colombia,3,9,6,2,4,D1,521
D,Brazil,3,6,7,4,3,D2,521
D,Paraguay,3,3,3,7,-4,D3,521
D,Costa Rica,3,0,1,4,-3,D4,521
A,Argentina,3,5,7,3,4,A1,522
A,Chile,3,5,2,1,1,A2,522
A,Peru,3,3,3,7,-4,A3,522
A,Canada,3,2,4,5,-1,A4,522
B,Mexico,3,7,5,3,2,B1,522
B,Venezuela,3,6,8,5,3,B2,522
B,Ecuador,3,4,5,6,-1,B3,522
B,Jamaica,3,0,2,6,-4,B4,522
C,Panama,3,7,4,1,3,C1,522
C,Uruguay,3,6,5,1,4,C2,522
C,United States,3,4,6,2,4,C3,522
C,Bolivia,3,0,0,11,-11,C4,522
D,Colombia,3,5,6,3,3,D1,522
D,Brazil,3,5,4,1,3,D2,522
D,Costa Rica,3,3,3,7,-4,D3,522
D,Paraguay,3,2,3,5,-2,D4,522
A,Argentina,3,6,5,2,3,A1,523
A,Chile,3,6,4,2,2,A2,523
A,Peru,3,3,3,4,-1,A3,523
A,Canada,3,3,3,7,-4,A4,523
B,Ecuador,3,7,5,1,4,B1,523
B,Mexico,3,6,5,2,3,B2,523
B,Venezuela,3,4,4,4,0,B3,523
B,Jamaica,3,0,1,8,-7,B4,523
C,United States,3,7,8,2,6,C1,523
C,Uruguay,3,4,4,7,-3,C2,523
C,Panama,3,3,4,4,0,C3,523
C,Bolivia,3,1,1,4,-3,C4,523
D,Colombia,3,7,4,1,3,D1,523
D,Brazil,3,6,6,3,3,D2,523
D,Costa Rica,3,3,2,5,-3,D3,523
D,Paraguay,3,1,0,3,-3,D4,523
A,Argentina,3,9,12,2,10,A1,524
A,Canada,3,6,4,6,-2,A2,524
A,Chile,3,1,3,7,-4,A3,524
A,Peru,3,1,1,5,-4,A4,524
B,Ecuador,3,6,7,4,3,B1,524
B,Mexico,3,6,5,3,2,B2,524
B,Venezuela,3,4,4,4,0,B3,524
B,Jamaica,3,1,3,8,-5,B4,524
C,United States,3,7,4,2,2,C1,524
C,Uruguay,3,6,5,3,2,C2,524
C,Bolivia,3,2,3,5,-2,C3,524
C,Panama,3,1,5,7,-2,C4,524
D,Brazil,3,7,6,0,6,D1,524
D,Paraguay,3,4,2,5,-3,D2,524
D,Colombia,3,3,2,2,0,D3,524
D,Costa Rica,3,1,1,4,-3,D4,524
A,Argentina,3,7,4,1,3,A1,525
A,Chile,3,6,5,3,2,A2,525
A,Peru,3,2,2,3,-1,A3,525
A,Canada,3,1,2,6,-4,A4,525
B,Ecuador,3,9,5,0,5,B1,525
B,Mexico,3,4,6,4,2,B2,525
B,Venezuela,3,2,4,6,-2,B3,525
B,Jamaica,3,1,1,6,-5,B4,525
C,Panama,3,6,4,3,1,C1,525
C,United States,3,6,4,3,1,C2,525
C,Bolivia,3,4,2,1,1,C3,525
C,Uruguay,3,1,1,4,-3,C4,525
D,Brazil,3,9,11,2,9,D1,525
D,Paraguay,3,4,2,4,-2,D2,525
D,Costa Rica,3,4,4,8,-4,D3,525
D,Colombia,3,0,4,7,-3,D4,525
A,Peru,3,9,3,0,3,A1,526
A,Argentina,3,6,5,1,4,A2,526
A,Chile,3,1,2,5,-3,A3,526
A,Canada,3,1,2,6,-4,A4,526
B,Mexico,3,6,5,3,2,B1,526
B,Ecuador,3,6,3,3,0,B2,526
B,Jamaica,3,4,3,2,1,B3,526
B,Venezuela,3,1,0,3,-3,B4,526
C,United States,3,9,7,1,6,C1,526
C,Uruguay,3,6,7,4,3,C2,526
C,Bolivia,3,3,3,7,-4,C3,526
C,Panama,3,0,2,7,-5,C4,526
D,Paraguay,3,9,6,1,5,D1,526
D,Brazil,3,4,5,4,1,D2,526
D,Colombia,3,3,4,5,-1,D3,526
D,Costa Rica,3,1,2,7,-5,D4,526
A,Argentina,3,9,6,0,6,A1,527
A,Chile,3,4,2,4,-2,A2,527
A,Peru,3,3,1,3,-2,A3,527
A,Canada,3,1,1,3,-2,A4,527
B,Ecuador,3,5,6,3,3,B1,527
B,Venezuela,3,5,6,4,2,B2,527
B,Mexico,3,2,1,3,-2,B3,527
B,Jamaica,3,2,2,5,-3,B4,527
C,United States,3,6,8,4,4,C1,527
C,Uruguay,3,4,3,3,0,C2,527
C,Panama,3,4,3,4,-1,C3,527
C,Bolivia,3,2,3,6,-3,C4,527
D,Brazil,3,7,3,0,3,D1,527
D,Colombia,3,4,2,3,-1,D2,527
D,Paraguay,3,3,1,1,0,D3,527
D,Costa Rica,3,1,0,2,-2,D4,527
A,Canada,3,7,5,0,5,A1,528
A,Argentina,3,5,3,2,1,A2,528
A,Peru,3,3,3,6,-3,A3,528
A,Chile,3,1,1,4,-3,A4,528
B,Ecuador,3,7,5,3,2,B1,528
B,Mexico,3,4,5,4,1,B2,528
B,Venezuela,3,4,2,2,0,B3,528
B,Jamaica,3,1,1,4,-3,B4,528
C,Uruguay,3,9,4,0,4,C1,528
C,United States,3,6,5,2,3,C2,528
C,Bolivia,3,3,2,5,-3,C3,528
C,Panama,3,0,1,5,-4,C4,528
D,Colombia,3,7,5,3,2,D1,528
D,Costa Rica,3,6,4,3,1,D2,528
D,Brazil,3,4,5,3,2,D3,528
D,Paraguay,3,0,3,8,-5,D4,528
A,Argentina,3,9,6,1,5,A1,529
A,Canada,3,4,3,4,-1,A2,529
A,Peru,3,3,3,5,-2,A3,529
A,Chile,3,1,1,3,-2,A4,529
B,Ecuador,3,6,4,2,2,B1,529
B,Mexico,3,6,4,2,2,B2,529
B,Venezuela,3,4,2,1,1,B3,529
B,Jamaica,3,1,1,6,-5,B4,529
C,Panama,3,6,3,4,-1,C1,529
C,Uruguay,3,5,6,3,3,C2,529
C,United States,3,4,2,2,0,C3,529
C,Bolivia,3,1,3,5,-2,C4,529
D,Costa Rica,3,6,5,2,3,D1,529
D,Brazil,3,6,4,2,2,D2,529
D,Colombia,3,4,3,4,-1,D3,529
D,Paraguay,3,1,1,5,-4,D4,529
A,Peru,3,5,7,2,5,A1,530
A,Argentina,3,4,5,4,1,A2,530
A,Canada,3,4,3,7,-4,A3,530
A,Chile,3,2,1,3,-2,A4,530
B,Ecuador,3,9,13,5,8,B1,530
B,Mexico,3,4,7,5,2,B2,530
B,Venezuela,3,2,3,5,-2,B3,530
B,Jamaica,3,1,0,8,-8,B4,530
C,United States,3,6,5,2,3,C1,530
C,Uruguay,3,6,3,2,1,C2,530
C,Bolivia,3,3,1,3,-2,C3,530
C,Panama,3,3,1,3,-2,C4,530
D,Brazil,3,9,8,1,7,D1,530
D,Colombia,3,4,3,3,0,D2,530
D,Paraguay,3,2,2,5,-3,D3,530
D,Costa Rica,3,1,2,6,-4,D4,530
A,Argentina,3,9,5,1,4,A1,531
A,Peru,3,6,4,2,2,A2,531
A,Canada,3,1,1,3,-2,A3,531
A,Chile,3,1,1,5,-4,A4,531
B,Jamaica,3,5,3,1,2,B1,531
B,Ecuador,3,4,2,2,0,B2,531
B,Mexico,3,4,1,1,0,B3,531
B,Venezuela,3,3,1,3,-2,B4,531
C,United States,3,7,5,1,4,C1,531
C,Bolivia,3,5,5,2,3,C2,531
C,Uruguay,3,2,2,3,-1,C3,531
C,Panama,3,1,1,7,-6,C4,531
D,Colombia,3,7,4,2,2,D1,531
D,Brazil,3,6,4,1,3,D2,531
D,Costa Rica,3,4,1,2,-1,D3,531
D,Paraguay,3,0,2,6,-4,D4,531
A,Argentina,3,6,8,3,5,A1,532
A,Chile,3,6,5,3,2,A2,532
A,Peru,3,3,3,4,-1,A3,532
A,Canada,3,3,3,9,-6,A4,532
B,Ecuador,3,6,5,2,3,B1,532
B,Mexico,3,6,5,3,2,B2,532
B,Venezuela,3,3,2,4,-2,B3,532
B,Jamaica,3,3,1,4,-3,B4,532
C,Uruguay,3,5,6,5,1,C1,532
C,Panama,3,4,5,3,2,C2,532
C,Bolivia,3,4,4,4,0,C3,532
C,United States,3,3,3,6,-3,C4,532
D,Brazil,3,7,4,2,2,D1,532
D,Colombia,3,5,1,0,1,D2,532
D,Costa Rica,3,3,2,3,-1,D3,532
D,Paraguay,3,1,3,5,-2,D4,532
A,Argentina,3,9,11,2,9,A1,533
A,Peru,3,4,4,4,0,A2,533
A,Chile,3,2,3,5,-2,A3,533
A,Canada,3,1,3,10,-7,A4,533
B,Ecuador,3,9,8,1,7,B1,533
B,Mexico,3,6,3,3,0,B2,533
B,Venezuela,3,1,2,5,-3,B3,533
B,Jamaica,3,1,2,6,-4,B4,533
C,Uruguay,3,7,6,1,5,C1,533
C,United States,3,5,4,3,1,C2,533
C,Bolivia,3,4,4,5,-1,C3,533
C,Panama,3,0,4,9,-5,C4,533
D,Brazil,3,9,8,1,7,D1,533
D,Paraguay,3,6,5,4,1,D2,533
D,Colombia,3,3,4,5,-1,D3,533
D,Costa Rica,3,0,3,10,-7,D4,533
A,Argentina,3,7,6,1,5,A1,534
A,Peru,3,5,3,1,2,A2,534
A,Canada,3,3,3,6,-3,A3,534
A,Chile,3,1,1,5,-4,A4,534
B,Mexico,3,7,8,2,6,B1,534
B,Jamaica,3,6,3,3,0,B2,534
B,Ecuador,3,2,2,4,-2,B3,534
B,Venezuela,3,1,2,6,-4,B4,534
C,Bolivia,3,4,10,10,0,C1,534
C,Panama,3,4,8,8,0,C2,534
C,Uruguay,3,4,7,7,0,C3,534
C,United States,3,3,6,6,0,C4,534
D,Colombia,3,9,8,1,7,D1,534
D,Brazil,3,6,4,3,1,D2,534
D,Paraguay,3,3,3,5,-2,D3,534
D,Costa Rica,3,0,0,6,-6,D4,534
A,Argentina,3,7,7,3,4,A1,535
A,Chile,3,4,2,3,-1,A2,535
A,Peru,3,3,2,3,-1,A3,535
A,Canada,3,3,5,7,-2,A4,535
B,Venezuela,3,7,4,1,3,B1,535
B,Mexico,3,5,8,3,5,B2,535
B,Ecuador,3,4,4,3,1,B3,535
B,Jamaica,3,0,0,9,-9,B4,535
C,United States,3,6,7,3,4,C1,535
C,Uruguay,3,5,6,5,1,C2,535
C,Panama,3,4,3,4,-1,C3,535
C,Bolivia,3,1,3,7,-4,C4,535
D,Colombia,3,7,6,0,6,D1,535
D,Brazil,3,5,2,1,1,D2,535
D,Costa Rica,3,2,3,5,-2,D3,535
D,Paraguay,3,1,2,7,-5,D4,535
A,Argentina,3,7,10,5,5,A1,536
A,Chile,3,5,3,2,1,A2,536
A,Canada,3,4,3,6,-3,A3,536
A,Peru,3,0,1,4,-3,A4,536
B,Ecuador,3,5,2,1,1,B1,536
B,Venezuela,3,3,3,3,0,B2,536
B,Mexico,3,3,2,2,0,B3,536
B,Jamaica,3,2,2,3,-1,B4,536
C,United States,3,6,6,4,2,C1,536
C,Panama,3,5,6,5,1,C2,536
C,Uruguay,3,4,9,4,5,C3,536
C,Bolivia,3,1,3,11,-8,C4,536
D,Brazil,3,9,9,1,8,D1,536
D,Colombia,3,4,3,5,-2,D2,536
D,Costa Rica,3,2,2,5,-3,D3,536
D,Paraguay,3,1,2,5,-3,D4,536
A,Argentina,3,7,7,1,6,A1,537
A,Chile,3,7,4,2,2,A2,537
A,Canada,3,1,1,5,-4,A3,537
A,Peru,3,1,0,4,-4,A4,537
B,Mexico,3,6,8,4,4,B1,537
B,Ecuador,3,6,6,3,3,B2,537
B,Venezuela,3,4,3,5,-2,B3,537
B,Jamaica,3,1,1,6,-5,B4,537
C,Uruguay,3,7,7,4,3,C1,537
C,United States,3,6,7,2,5,C2,537
C,Panama,3,4,5,2,3,C3,537
C,Bolivia,3,0,2,13,-11,C4,537
D,Brazil,3,7,8,0,8,D1,537
D,Colombia,3,7,8,0,8,D2,537
D,Costa Rica,3,3,2,8,-6,D3,537
D,Paraguay,3,0,0,10,-10,D4,537
A,Argentina,3,5,3,2,1,A1,538
A,Canada,3,4,3,3,0,A2,538
A,Peru,3,4,1,1,0,A3,538
A,Chile,3,2,2,3,-1,A4,538
B,Jamaica,3,9,7,1,6,B1,538
B,Ecuador,3,6,3,3,0,B2,538
B,Mexico,3,3,2,3,-1,B3,538
B,Venezuela,3,0,1,6,-5,B4,538
C,United States,3,9,5,1,4,C1,538
C,Uruguay,3,6,8,2,6,C2,538
C,Panama,3,1,1,5,-4,C3,538
C,Bolivia,3,1,1,7,-6,C4,538
D,Brazil,3,9,11,1,10,D1,538
D,Costa Rica,3,4,2,6,-4,D2,538
D,Paraguay,3,3,3,7,-4,D3,538
D,Colombia,3,1,0,2,-2,D4,538
A,Argentina,3,7,6,1,5,A1,539
A,Chile,3,6,3,3,0,A2,539
A,Canada,3,3,4,5,-1,A3,539
A,Peru,3,1,1,5,-4,A4,539
B,Ecuador,3,9,6,1,5,B1,539
B,Jamaica,3,4,2,3,-1,B2,539
B,Mexico,3,4,2,3,-1,B3,539
B,Venezuela,3,0,1,4,-3,B4,539
C,United States,3,7,4,1,3,C1,539
C,Uruguay,3,4,5,5,0,C2,539
C,Bolivia,3,2,4,5,-1,C3,539
C,Panama,3,2,1,3,-2,C4,539
D,Brazil,3,7,4,1,3,D1,539
D,Colombia,3,6,4,2,2,D2,539
D,Costa Rica,3,4,1,3,-2,D3,539
D,Paraguay,3,0,1,4,-3,D4,539
A,Argentina,3,9,8,3,5,A1,540
A,Canada,3,4,3,2,1,A2,540
A,Peru,3,4,4,5,-1,A3,540
A,Chile,3,0,2,7,-5,A4,540
B,Jamaica,3,5,6,5,1,B1,540
B,Ecuador,3,4,5,5,0,B2,540
B,Venezuela,3,4,5,5,0,B3,540
B,Mexico,3,2,3,4,-1,B4,540
C,United States,3,9,8,1,7,C1,540
C,Uruguay,3,4,4,5,-1,C2,540
C,Panama,3,2,4,5,-1,C3,540
C,Bolivia,3,1,1,6,-5,C4,540
D,Brazil,3,9,5,1,4,D1,540
D,Paraguay,3,4,3,3,0,D2,540
D,Colombia,3,2,1,2,-1,D3,540
D,Costa Rica,3,1,1,4,-3,D4,540
A,Argentina,3,6,6,2,4,A1,541
A,Canada,3,6,3,4,-1,A2,541
A,Peru,3,4,1,2,-1,A3,541
A,Chile,3,1,1,3,-2,A4,541
B,Ecuador,3,7,6,4,2,B1,541
B,Mexico,3,5,7,4,3,B2,541
B,Venezuela,3,2,3,4,-1,B3,541
B,Jamaica,3,1,1,5,-4,B4,541
C,Uruguay,3,9,7,0,7,C1,541
C,United States,3,6,2,2,0,C2,541
C,Bolivia,3,3,2,4,-2,C3,541
C,Panama,3,0,1,6,-5,C4,541
D,Brazil,3,7,7,2,5,D1,541
D,Paraguay,3,4,4,4,0,D2,541
D,Colombia,3,4,2,3,-1,D3,541
D,Costa Rica,3,1,0,4,-4,D4,541
A,Argentina,3,5,6,3,3,A1,542
A,Chile,3,5,3,2,1,A2,542
A,Peru,3,2,3,4,-1,A3,542
A,Canada,3,2,2,5,-3,A4,542
B,Jamaica,3,7,4,2,2,B1,542
B,Venezuela,3,4,4,4,0,B2,542
B,Mexico,3,3,5,5,0,B3,542
B,Ecuador,3,3,2,4,-2,B4,542
C,United States,3,7,5,2,3,C1,542
C,Panama,3,4,4,4,0,C2,542
C,Uruguay,3,3,2,2,0,C3,542
C,Bolivia,3,1,2,5,-3,C4,542
D,Costa Rica,3,7,6,2,4,D1,542
D,Brazil,3,5,8,3,5,D2,542
D,Colombia,3,2,2,5,-3,D3,542
D,Paraguay,3,1,1,7,-6,D4,542
A,Canada,3,5,5,2,3,A1,543
A,Argentina,3,5,3,2,1,A2,543
A,Peru,3,3,3,6,-3,A3,543
A,Chile,3,2,4,5,-1,A4,543
B,Venezuela,3,6,4,3,1,B1,543
B,Mexico,3,6,3,2,1,B2,543
B,Ecuador,3,4,4,3,1,B3,543
B,Jamaica,3,1,2,5,-3,B4,543
C,United States,3,9,5,1,4,C1,543
C,Panama,3,4,5,3,2,C2,543
C,Bolivia,3,3,2,5,-3,C3,543
C,Uruguay,3,1,1,4,-3,C4,543
D,Brazil,3,9,7,1,6,D1,543
D,Colombia,3,4,3,3,0,D2,543
D,Paraguay,3,4,4,5,-1,D3,543
D,Costa Rica,3,0,1,6,-5,D4,543
A,Chile,3,7,5,2,3,A1,544
A,Argentina,3,5,4,3,1,A2,544
A,Peru,3,3,5,6,-1,A3,544
A,Canada,3,1,4,7,-3,A4,544
B,Ecuador,3,9,12,0,12,B1,544
B,Venezuela,3,6,3,4,-1,B2,544
B,Jamaica,3,1,2,7,-5,B3,544
B,Mexico,3,1,1,7,-6,B4,544
C,Uruguay,3,7,2,0,2,C1,544
C,United States,3,6,5,2,3,C2,544
C,Panama,3,2,1,3,-2,C3,544
C,Bolivia,3,1,0,3,-3,C4,544
D,Brazil,3,9,8,1,7,D1,544
D,Colombia,3,6,6,1,5,D2,544
D,Costa Rica,3,1,2,7,-5,D3,544
D,Paraguay,3,1,1,8,-7,D4,544
A,Argentina,3,6,6,4,2,A1,545
A,Chile,3,6,5,3,2,A2,545
A,Peru,3,4,3,3,0,A3,545
A,Canada,3,1,3,7,-4,A4,545
B,Venezuela,3,7,6,4,2,B1,545
B,Mexico,3,4,5,4,1,B2,545
B,Jamaica,3,4,3,4,-1,B3,545
B,Ecuador,3,1,3,5,-2,B4,545
C,Uruguay,3,9,4,0,4,C1,545
C,Panama,3,6,2,2,0,C2,545
C,United States,3,3,1,2,-1,C3,545
C,Bolivia,3,0,0,3,-3,C4,545
D,Brazil,3,9,11,0,11,D1,545
D,Paraguay,3,4,1,2,-1,D2,545
D,Colombia,3,4,1,3,-2,D3,545
D,Costa Rica,3,0,0,8,-8,D4,545
A,Argentina,3,9,9,1,8,A1,546
A,Canada,3,6,5,6,-1,A2,546
A,Chile,3,3,4,5,-1,A3,546
A,Peru,3,0,0,6,-6,A4,546
B,Ecuador,3,7,5,0,5,B1,546
B,Mexico,3,6,4,5,-1,B2,546
B,Venezuela,3,4,2,2,0,B3,546
B,Jamaica,3,0,1,5,-4,B4,546
C,United States,3,9,6,2,4,C1,546
C,Uruguay,3,4,6,3,3,C2,546
C,Bolivia,3,4,3,3,0,C3,546
C,Panama,3,0,1,8,-7,C4,546
D,Brazil,3,7,8,1,7,D1,546
D,Colombia,3,6,5,2,3,D2,546
D,Paraguay,3,2,2,6,-4,D3,546
D,Costa Rica,3,1,1,7,-6,D4,546
A,Argentina,3,9,7,0,7,A1,547
A,Canada,3,6,6,5,1,A2,547
A,Peru,3,1,1,4,-3,A3,547
A,Chile,3,1,3,8,-5,A4,547
B,Ecuador,3,9,7,1,6,B1,547
B,Mexico,3,6,4,3,1,B2,547
B,Venezuela,3,3,3,3,0,B3,547
B,Jamaica,3,0,0,7,-7,B4,547
C,Uruguay,3,7,6,2,4,C1,547
C,Bolivia,3,6,4,5,-1,C2,547
C,United States,3,3,3,3,0,C3,547
C,Panama,3,1,3,6,-3,C4,547
D,Brazil,3,7,7,1,6,D1,547
D,Paraguay,3,5,2,1,1,D2,547
D,Colombia,3,4,3,2,1,D3,547
D,Costa Rica,3,0,1,9,-8,D4,547
A,Argentina,3,7,6,1,5,A1,548
A,Canada,3,4,5,6,-1,A2,548
A,Chile,3,2,3,5,-2,A3,548
A,Peru,3,2,1,3,-2,A4,548
B,Mexico,3,7,6,2,4,B1,548
B,Jamaica,3,7,3,0,3,B2,548
B,Ecuador,3,3,2,4,-2,B3,548
B,Venezuela,3,0,1,6,-5,B4,548
C,Uruguay,3,9,8,1,7,C1,548
C,United States,3,6,6,3,3,C2,548
C,Bolivia,3,3,2,8,-6,C3,548
C,Panama,3,0,0,4,-4,C4,548
D,Brazil,3,9,4,0,4,D1,548
D,Colombia,3,6,6,2,4,D2,548
D,Costa Rica,3,1,0,4,-4,D3,548
D,Paraguay,3,1,0,4,-4,D4,548
A,Argentina,3,9,7,2,5,A1,549
A,Peru,3,6,4,4,0,A2,549
A,Chile,3,3,2,4,-2,A3,549
A,Canada,3,0,3,6,-3,A4,549
B,Ecuador,3,6,4,2,2,B1,549
B,Mexico,3,6,3,1,2,B2,549
B,Jamaica,3,3,2,4,-2,B3,549
B,Venezuela,3,3,2,4,-2,B4,549
C,Uruguay,3,9,10,1,9,C1,549
C,United States,3,4,4,4,0,C2,549
C,Panama,3,3,2,5,-3,C3,549
C,Bolivia,3,1,2,8,-6,C4,549
D,Brazil,3,7,4,0,4,D1,549
D,Paraguay,3,4,1,3,-2,D2,549
D,Colombia,3,3,4,5,-1,D3,549
D,Costa Rica,3,2,3,4,-1,D4,549
A,Argentina,3,9,6,1,5,A1,550
A,Chile,3,6,8,4,4,A2,550
A,Peru,3,1,2,5,-3,A3,550
A,Canada,3,1,2,8,-6,A4,550
B,Ecuador,3,6,5,3,2,B1,550
B,Mexico,3,4,4,3,1,B2,550
B,Venezuela,3,4,5,5,0,B3,550
B,Jamaica,3,3,4,7,-3,B4,550
C,Uruguay,3,7,5,3,2,C1,550
C,United States,3,5,5,3,2,C2,550
C,Panama,3,4,4,3,1,C3,550
C,Bolivia,3,0,2,7,-5,C4,550
D,Brazil,3,7,5,2,3,D1,550
D,Paraguay,3,5,4,1,3,D2,550
D,Colombia,3,4,3,3,0,D3,550
D,Costa Rica,3,0,0,6,-6,D4,550
A,Argentina,3,9,8,0,8,A1,551
A,Canada,3,4,4,8,-4,A2,551
A,Chile,3,3,3,4,-1,A3,551
A,Peru,3,1,1,4,-3,A4,551
B,Ecuador,3,7,5,2,3,B1,551
B,Mexico,3,4,2,2,0,B2,551
B,Jamaica,3,2,1,2,-1,B3,551
B,Venezuela,3,2,1,3,-2,B4,551
C,Uruguay,3,7,6,2,4,C1,551
C,United States,3,7,4,0,4,C2,551
C,Panama,3,3,4,6,-2,C3,551
C,Bolivia,3,0,3,9,-6,C4,551
D,Brazil,3,7,4,1,3,D1,551
D,Paraguay,3,4,3,4,-1,D2,551
D,Colombia,3,2,2,3,-1,D3,551
D,Costa Rica,3,2,1,2,-1,D4,551
A,Chile,3,7,4,1,3,A1,552
A,Peru,3,4,3,2,1,A2,552
A,Canada,3,3,4,6,-2,A3,552
A,Argentina,3,2,2,4,-2,A4,552
B,Venezuela,3,5,4,1,3,B1,552
B,Ecuador,3,5,2,0,2,B2,552
B,Jamaica,3,3,2,6,-4,B3,552
B,Mexico,3,2,2,3,-1,B4,552
C,Uruguay,3,9,7,1,6,C1,552
C,United States,3,6,6,4,2,C2,552
C,Bolivia,3,3,3,5,-2,C3,552
C,Panama,3,0,2,8,-6,C4,552
D,Brazil,3,7,5,2,3,D1,552
D,Colombia,3,4,4,3,1,D2,552
D,Paraguay,3,3,4,6,-2,D3,552
D,Costa Rica,3,3,1,3,-2,D4,552
A,Argentina,3,7,5,1,4,A1,553
A,Chile,3,4,2,2,0,A2,553
A,Canada,3,2,2,3,-1,A3,553
A,Peru,3,2,0,3,-3,A4,553
B,Mexico,3,7,6,4,2,B1,553
B,Venezuela,3,6,7,3,4,B2,553
B,Ecuador,3,4,6,6,0,B3,553
B,Jamaica,3,0,0,6,-6,B4,553
C,United States,3,7,9,2,7,C1,553
C,Uruguay,3,7,4,1,3,C2,553
C,Panama,3,3,4,7,-3,C3,553
C,Bolivia,3,0,1,8,-7,C4,553
D,Brazil,3,7,11,2,9,D1,553
D,Colombia,3,5,3,2,1,D2,553
D,Costa Rica,3,2,0,4,-4,D3,553
D,Paraguay,3,1,0,6,-6,D4,553
A,Argentina,3,7,7,3,4,A1,554
A,Chile,3,6,5,4,1,A2,554
A,Canada,3,3,1,4,-3,A3,554
A,Peru,3,1,2,4,-2,A4,554
B,Venezuela,3,6,5,3,2,B1,554
B,Ecuador,3,5,2,1,1,B2,554
B,Mexico,3,4,5,4,1,B3,554
B,Jamaica,3,1,1,5,-4,B4,554
C,United States,3,7,11,4,7,C1,554
C,Uruguay,3,5,4,3,1,C2,554
C,Bolivia,3,2,2,6,-4,C3,554
C,Panama,3,1,1,5,-4,C4,554
D,Brazil,3,7,8,1,7,D1,554
D,Colombia,3,7,2,0,2,D2,554
D,Paraguay,3,1,2,4,-2,D3,554
D,Costa Rica,3,1,1,8,-7,D4,554
A,Chile,3,7,6,3,3,A1,555
A,Argentina,3,6,8,4,4,A2,555
A,Peru,3,4,2,3,-1,A3,555
A,Canada,3,0,1,7,-6,A4,555
B,Mexico,3,6,5,3,2,B1,555
B,Ecuador,3,4,5,6,-1,B2,555
B,Jamaica,3,4,4,5,-1,B3,555
B,Venezuela,3,3,5,5,0,B4,555
C,Uruguay,3,7,6,1,5,C1,555
C,United States,3,6,7,2,5,C2,555
C,Panama,3,3,3,8,-5,C3,555
C,Bolivia,3,1,0,5,-5,C4,555
D,Brazil,3,5,2,1,1,D1,555
D,Costa Rica,3,4,3,2,1,D2,555
D,Paraguay,3,4,4,5,-1,D3,555
D,Colombia,3,3,4,5,-1,D4,555
A,Argentina,3,7,7,2,5,A1,556
A,Peru,3,4,7,3,4,A2,556
A,Canada,3,4,1,3,-2,A3,556
A,Chile,3,1,0,7,-7,A4,556
B,Ecuador,3,9,6,2,4,B1,556
B,Mexico,3,4,3,2,1,B2,556
B,Venezuela,3,3,4,6,-2,B3,556
B,Jamaica,3,1,3,6,-3,B4,556
C,Uruguay,3,9,8,2,6,C1,556
C,United States,3,4,4,3,1,C2,556
C,Bolivia,3,3,3,7,-4,C3,556
C,Panama,3,1,0,3,-3,C4,556
D,Colombia,3,7,5,2,3,D1,556
D,Brazil,3,6,4,2,2,D2,556
D,Costa Rica,3,3,1,3,-2,D3,556
D,Paraguay,3,1,1,4,-3,D4,556
A,Peru,3,6,5,5,0,A1,557
A,Argentina,3,5,6,3,3,A2,557
A,Chile,3,4,3,3,0,A3,557
A,Canada,3,1,0,3,-3,A4,557
B,Mexico,3,7,5,0,5,B1,557
B,Venezuela,3,5,4,3,1,B2,557
B,Ecuador,3,2,2,4,-2,B3,557
B,Jamaica,3,1,3,7,-4,B4,557
C,Uruguay,3,7,6,3,3,C1,557
C,United States,3,5,6,4,2,C2,557
C,Panama,3,4,6,7,-1,C3,557
C,Bolivia,3,0,4,8,-4,C4,557
D,Brazil,3,7,10,4,6,D1,557
D,Colombia,3,7,5,2,3,D2,557
D,Paraguay,3,3,3,4,-1,D3,557
D,Costa Rica,3,0,0,8,-8,D4,557
A,Argentina,3,7,8,1,7,A1,558
A,Peru,3,6,4,4,0,A2,558
A,Canada,3,3,3,7,-4,A3,558
A,Chile,3,1,1,4,-3,A4,558
B,Mexico,3,6,6,1,5,B1,558
B,Venezuela,3,6,5,4,1,B2,558
B,Ecuador,3,4,2,2,0,B3,558
B,Jamaica,3,1,2,8,-6,B4,558
C,United States,3,7,7,1,6,C1,558
C,Uruguay,3,4,2,2,0,C2,558
C,Panama,3,3,5,7,-2,C3,558
C,Bolivia,3,3,2,6,-4,C4,558
D,Brazil,3,6,9,3,6,D1,558
D,Colombia,3,6,5,2,3,D2,558
D,Costa Rica,3,6,2,5,-3,D3,558
D,Paraguay,3,0,1,7,-6,D4,558
A,Argentina,3,9,7,1,6,A1,559
A,Canada,3,4,3,4,-1,A2,559
A,Peru,3,4,2,3,-1,A3,559
A,Chile,3,0,0,4,-4,A4,559
B,Ecuador,3,9,5,1,4,B1,559
B,Mexico,3,4,3,3,0,B2,559
B,Jamaica,3,4,2,3,-1,B3,559
B,Venezuela,3,0,2,5,-3,B4,559
C,Uruguay,3,5,5,1,4,C1,559
C,United States,3,5,3,1,2,C2,559
C,Panama,3,3,3,3,0,C3,559
C,Bolivia,3,1,1,7,-6,C4,559
D,Paraguay,3,7,4,2,2,D1,559
D,Costa Rica,3,5,1,0,1,D2,559
D,Brazil,3,4,4,3,1,D3,559
D,Colombia,3,0,2,6,-4,D4,559
A,Argentina,3,5,5,3,2,A1,560
A,Chile,3,4,5,5,0,A2,560
A,Canada,3,4,3,4,-1,A3,560
A,Peru,3,2,2,3,-1,A4,560
B,Mexico,3,9,8,4,4,B1,560
B,Ecuador,3,4,6,3,3,B2,560
B,Venezuela,3,4,3,4,-1,B3,560
B,Jamaica,3,0,2,8,-6,B4,560
C,Uruguay,3,9,7,3,4,C1,560
C,United States,3,6,8,5,3,C2,560
C,Panama,3,1,5,7,-2,C3,560
C,Bolivia,3,1,4,9,-5,C4,560
D,Costa Rica,3,5,3,2,1,D1,560
D,Colombia,3,4,4,3,1,D2,560
D,Paraguay,3,4,6,6,0,D3,560
D,Brazil,3,3,3,5,-2,D4,560
A,Argentina,3,9,9,1,8,A1,561
A,Peru,3,4,3,5,-2,A2,561
A,Canada,3,2,2,4,-2,A3,561
A,Chile,3,1,2,6,-4,A4,561
B,Ecuador,3,9,8,1,7,B1,561
B,Mexico,3,6,5,3,2,B2,561
B,Jamaica,3,3,3,5,-2,B3,561
B,Venezuela,3,0,0,7,-7,B4,561
C,United States,3,6,8,3,5,C1,561
C,Uruguay,3,4,5,4,1,C2,561
C,Bolivia,3,4,4,5,-1,C3,561
C,Panama,3,3,1,6,-5,C4,561
D,Brazil,3,9,9,2,7,D1,561
D,Paraguay,3,4,5,3,2,D2,561
D,Colombia,3,4,4,4,0,D3,561
D,Costa Rica,3,0,0,9,-9,D4,561
A,Peru,3,7,3,1,2,A1,562
A,Chile,3,6,2,1,1,A2,562
A,Argentina,3,4,3,2,1,A3,562
A,Canada,3,0,0,4,-4,A4,562
B,Mexico,3,5,3,2,1,B1,562
B,Venezuela,3,4,5,3,2,B2,562
B,Jamaica,3,4,4,5,-1,B3,562
B,Ecuador,3,2,2,4,-2,B4,562
C,Uruguay,3,7,6,4,2,C1,562
C,Panama,3,4,4,3,1,C2,562
C,Bolivia,3,4,5,6,-1,C3,562
C,United States,3,1,4,6,-2,C4,562
D,Colombia,3,6,5,4,1,D1,562
D,Costa Rica,3,4,5,3,2,D2,562
D,Brazil,3,4,2,1,1,D3,562
D,Paraguay,3,3,1,5,-4,D4,562
A,Argentina,3,7,6,3,3,A1,563
A,Canada,3,4,5,4,1,A2,563
A,Chile,3,2,2,4,-2,A3,563
A,Peru,3,2,2,4,-2,A4,563
B,Mexico,3,5,4,3,1,B1,563
B,Jamaica,3,3,3,3,0,B2,563
B,Venezuela,3,3,2,2,0,B3,563
B,Ecuador,3,2,2,3,-1,B4,563
C,United States,3,9,7,2,5,C1,563
C,Panama,3,4,5,4,1,C2,563
C,Bolivia,3,2,0,3,-3,C3,563
C,Uruguay,3,1,1,4,-3,C4,563
D,Brazil,3,9,7,1,6,D1,563
D,Costa Rica,3,4,3,6,-3,D2,563
D,Paraguay,3,2,3,4,-1,D3,563
D,Colombia,3,1,2,4,-2,D4,563
A,Argentina,3,5,3,2,1,A1,564
A,Chile,3,4,1,1,0,A2,564
A,Peru,3,4,4,5,-1,A3,564
A,Canada,3,3,3,3,0,A4,564
B,Ecuador,3,7,10,3,7,B1,564
B,Mexico,3,4,2,2,0,B2,564
B,Venezuela,3,3,3,6,-3,B3,564
B,Jamaica,3,3,3,7,-4,B4,564
C,Uruguay,3,9,10,0,10,C1,564
C,United States,3,4,4,3,1,C2,564
C,Panama,3,3,1,4,-3,C3,564
C,Bolivia,3,1,1,9,-8,C4,564
D,Brazil,3,9,12,0,12,D1,564
D,Costa Rica,3,3,3,7,-4,D2,564
D,Colombia,3,3,1,5,-4,D3,564
D,Paraguay,3,3,1,5,-4,D4,564
A,Canada,3,5,4,3,1,A1,565
A,Argentina,3,4,6,3,3,A2,565
A,Chile,3,3,1,1,0,A3,565
A,Peru,3,2,2,6,-4,A4,565
B,Mexico,3,7,6,1,5,B1,565
B,Ecuador,3,5,4,1,3,B2,565
B,Venezuela,3,4,4,6,-2,B3,565
B,Jamaica,3,0,1,7,-6,B4,565
C,United States,3,9,6,2,4,C1,565
C,Uruguay,3,6,8,3,5,C2,565
C,Panama,3,3,4,8,-4,C3,565
C,Bolivia,3,0,1,6,-5,C4,565
D,Brazil,3,7,7,2,5,D1,565
D,Costa Rica,3,6,3,3,0,D2,565
D,Colombia,3,2,1,3,-2,D3,565
D,Paraguay,3,1,3,6,-3,D4,565
A,Argentina,3,9,9,2,7,A1,566
A,Canada,3,4,4,4,0,A2,566
A,Chile,3,4,5,6,-1,A3,566
A,Peru,3,0,3,9,-6,A4,566
B,Mexico,3,9,7,0,7,B1,566
B,Ecuador,3,2,2,4,-2,B2,566
B,Jamaica,3,2,2,4,-2,B3,566
B,Venezuela,3,2,2,5,-3,B4,566
C,Uruguay,3,7,5,3,2,C1,566
C,United States,3,5,7,3,4,C2,566
C,Bolivia,3,4,4,4,0,C3,566
C,Panama,3,0,3,9,-6,C4,566
D,Brazil,3,7,6,1,5,D1,566
D,Colombia,3,4,1,1,0,D2,566
D,Paraguay,3,3,4,6,-2,D3,566
D,Costa Rica,3,3,2,5,-3,D4,566
A,Argentina,3,9,6,1,5,A1,567
A,Chile,3,6,6,4,2,A2,567
A,Peru,3,3,7,8,-1,A3,567
A,Canada,3,0,3,9,-6,A4,567
B,Mexico,3,9,8,2,6,B1,567
B,Ecuador,3,4,2,1,1,B2,567
B,Venezuela,3,3,6,7,-1,B3,567
B,Jamaica,3,1,1,7,-6,B4,567
C,Uruguay,3,5,4,3,1,C1,567
C,United States,3,4,4,2,2,C2,567
C,Bolivia,3,4,3,3,0,C3,567
C,Panama,3,2,2,5,-3,C4,567
D,Brazil,3,9,8,1,7,D1,567
D,Colombia,3,4,2,3,-1,D2,567
D,Paraguay,3,2,1,2,-1,D3,567
D,Costa Rica,3,1,0,5,-5,D4,567
A,Argentina,3,7,8,2,6,A1,568
A,Chile,3,7,4,2,2,A2,568
A,Canada,3,3,1,6,-5,A3,568
A,Peru,3,0,0,3,-3,A4,568
B,Ecuador,3,6,3,1,2,B1,568
B,Venezuela,3,4,3,1,2,B2,568
B,Jamaica,3,4,2,4,-2,B3,568
B,Mexico,3,2,1,3,-2,B4,568
C,Uruguay,3,7,8,2,6,C1,568
C,United States,3,4,1,4,-3,C2,568
C,Panama,3,3,4,4,0,C3,568
C,Bolivia,3,2,3,6,-3,C4,568
D,Brazil,3,7,4,2,2,D1,568
D,Costa Rica,3,7,4,2,2,D2,568
D,Colombia,3,1,1,3,-2,D3,568
D,Paraguay,3,1,1,3,-2,D4,568
A,Canada,3,6,3,3,0,A1,569
A,Argentina,3,5,3,1,2,A2,569
A,Chile,3,2,2,3,-1,A3,569
A,Peru,3,2,2,3,-1,A4,569
B,Jamaica,3,7,4,2,2,B1,569
B,Ecuador,3,5,3,2,1,B2,569
B,Mexico,3,2,0,1,-1,B3,569
B,Venezuela,3,1,2,4,-2,B4,569
C,Uruguay,3,7,8,4,4,C1,569
C,Bolivia,3,4,4,4,0,C2,569
C,United States,3,2,2,3,-1,C3,569
C,Panama,3,2,1,4,-3,C4,569
D,Brazil,3,7,6,0,6,D1,569
D,Colombia,3,6,4,3,1,D2,569
D,Paraguay,3,4,2,2,0,D3,569
D,Costa Rica,3,0,0,7,-7,D4,569
A,Canada,3,6,4,3,1,A1,570
A,Argentina,3,6,3,3,0,A2,570
A,Peru,3,4,3,2,1,A3,570
A,Chile,3,1,1,3,-2,A4,570
B,Ecuador,3,6,9,4,5,B1,570
B,Venezuela,3,4,4,4,0,B2,570
B,Mexico,3,4,6,9,-3,B3,570
B,Jamaica,3,2,3,5,-2,B4,570
C,Uruguay,3,6,7,3,4,C1,570
C,United States,3,6,4,2,2,C2,570
C,Bolivia,3,4,3,7,-4,C3,570
C,Panama,3,1,2,4,-2,C4,570
D,Brazil,3,6,6,1,5,D1,570
D,Paraguay,3,6,4,2,2,D2,570
D,Colombia,3,6,4,4,0,D3,570
D,Costa Rica,3,0,0,7,-7,D4,570
A,Chile,3,6,7,2,5,A1,571
A,Canada,3,6,3,6,-3,A2,571
A,Argentina,3,3,4,3,1,A3,571
A,Peru,3,3,2,5,-3,A4,571
B,Ecuador,3,7,5,3,2,B1,571
B,Jamaica,3,6,2,1,1,B2,571
B,Venezuela,3,4,2,2,0,B3,571
B,Mexico,3,0,2,5,-3,B4,571
C,United States,3,9,10,4,6,C1,571
C,Uruguay,3,4,2,2,0,C2,571
C,Bolivia,3,2,3,5,-2,C3,571
C,Panama,3,1,2,6,-4,C4,571
D,Brazil,3,7,5,3,2,D1,571
D,Colombia,3,5,4,3,1,D2,571
D,Paraguay,3,3,3,4,-1,D3,571
D,Costa Rica,3,1,4,6,-2,D4,571
A,Chile,3,7,12,4,8,A1,572
A,Argentina,3,6,4,2,2,A2,572
A,Peru,3,2,3,4,-1,A3,572
A,Canada,3,1,2,11,-9,A4,572
B,Jamaica,3,6,5,4,1,B1,572
B,Mexico,3,4,6,6,0,B2,572
B,Ecuador,3,4,4,4,0,B3,572
B,Venezuela,3,3,6,7,-1,B4,572
C,Uruguay,3,7,5,3,2,C1,572
C,United States,3,4,5,4,1,C2,572
C,Panama,3,3,2,3,-1,C3,572
C,Bolivia,3,2,4,6,-2,C4,572
D,Brazil,3,6,6,4,2,D1,572
D,Paraguay,3,6,4,4,0,D2,572
D,Colombia,3,4,3,3,0,D3,572
D,Costa Rica,3,1,4,6,-2,D4,572
A,Argentina,3,7,8,2,6,A1,573
A,Peru,3,4,2,3,-1,A2,573
A,Chile,3,3,1,5,-4,A3,573
A,Canada,3,2,3,4,-1,A4,573
B,Mexico,3,7,4,2,2,B1,573
B,Ecuador,3,5,5,4,1,B2,573
B,Venezuela,3,4,5,4,1,B3,573
B,Jamaica,3,0,1,5,-4,B4,573
C,United States,3,7,6,3,3,C1,573
C,Uruguay,3,5,5,1,4,C2,573
C,Panama,3,2,5,6,-1,C3,573
C,Bolivia,3,1,3,9,-6,C4,573
D,Brazil,3,7,3,0,3,D1,573
D,Colombia,3,6,2,1,1,D2,573
D,Costa Rica,3,3,2,3,-1,D3,573
D,Paraguay,3,1,0,3,-3,D4,573
A,Chile,3,7,6,3,3,A1,574
A,Peru,3,4,6,6,0,A2,574
A,Argentina,3,4,3,4,-1,A3,574
A,Canada,3,1,6,8,-2,A4,574
B,Mexico,3,7,4,0,4,B1,574
B,Ecuador,3,4,5,2,3,B2,574
B,Venezuela,3,4,2,4,-2,B3,574
B,Jamaica,3,1,1,6,-5,B4,574
C,Uruguay,3,5,6,4,2,C1,574
C,United States,3,4,5,4,1,C2,574
C,Bolivia,3,4,3,4,-1,C3,574
C,Panama,3,2,3,5,-2,C4,574
D,Brazil,3,7,15,5,10,D1,574
D,Colombia,3,5,4,3,1,D2,574
D,Costa Rica,3,2,2,10,-8,D3,574
D,Paraguay,3,1,2,5,-3,D4,574
A,Peru,3,7,3,0,3,A1,575
A,Argentina,3,4,5,3,2,A2,575
A,Canada,3,2,2,4,-2,A3,575
A,Chile,3,2,2,5,-3,A4,575
B,Venezuela,3,5,6,5,1,B1,575
B,Mexico,3,5,4,3,1,B2,575
B,Ecuador,3,4,3,2,1,B3,575
B,Jamaica,3,1,3,6,-3,B4,575
C,United States,3,9,4,0,4,C1,575
C,Uruguay,3,6,5,2,3,C2,575
C,Panama,3,3,2,3,-1,C3,575
C,Bolivia,3,0,0,6,-6,C4,575
D,Brazil,3,9,7,1,6,D1,575
D,Colombia,3,6,5,2,3,D2,575
D,Paraguay,3,3,3,3,0,D3,575
D,Costa Rica,3,0,0,9,-9,D4,575
A,Peru,3,7,3,1,2,A1,576
A,Argentina,3,4,2,1,1,A2,576
A,Chile,3,4,3,3,0,A3,576
A,Canada,3,1,2,5,-3,A4,576
B,Mexico,3,7,7,3,4,B1,576
B,Ecuador,3,6,3,2,1,B2,576
B,Venezuela,3,2,3,4,-1,B3,576
B,Jamaica,3,1,0,4,-4,B4,576
C,Uruguay,3,9,7,0,7,C1,576
C,United States,3,4,1,1,0,C2,576
C,Panama,3,3,3,7,-4,C3,576
C,Bolivia,3,1,1,4,-3,C4,576
D,Brazil,3,9,7,0,7,D1,576
D,Colombia,3,6,2,1,1,D2,576
D,Paraguay,3,3,1,2,-1,D3,576
D,Costa Rica,3,0,0,7,-7,D4,576
A,Argentina,3,9,4,1,3,A1,577
A,Chile,3,6,5,2,3,A2,577
A,Canada,3,3,3,5,-2,A3,577
A,Peru,3,0,1,5,-4,A4,577
B,Mexico,3,7,4,2,2,B1,577
B,Ecuador,3,4,1,2,-1,B2,577
B,Venezuela,3,3,3,3,0,B3,577
B,Jamaica,3,3,3,4,-1,B4,577
C,Uruguay,3,7,4,1,3,C1,577
C,United States,3,7,3,1,2,C2,577
C,Panama,3,3,3,4,-1,C3,577
C,Bolivia,3,0,1,5,-4,C4,577
D,Brazil,3,9,6,1,5,D1,577
D,Colombia,3,6,6,2,4,D2,577
D,Costa Rica,3,3,1,5,-4,D3,577
D,Paraguay,3,0,0,5,-5,D4,577
A,Canada,3,6,6,3,3,A1,578
A,Peru,3,6,4,2,2,A2,578
A,Argentina,3,6,3,1,2,A3,578
A,Chile,3,0,1,8,-7,A4,578
B,Mexico,3,6,7,3,4,B1,578
B,Venezuela,3,5,3,2,1,B2,578
B,Ecuador,3,4,1,4,-3,B3,578
B,Jamaica,3,1,2,4,-2,B4,578
C,Bolivia,3,6,3,1,2,C1,578
C,Panama,3,6,3,2,1,C2,578
C,United States,3,6,2,2,0,C3,578
C,Uruguay,3,0,1,4,-3,C4,578
D,Brazil,3,9,9,1,8,D1,578
D,Paraguay,3,6,4,5,-1,D2,578
D,Colombia,3,3,5,3,2,D3,578
D,Costa Rica,3,0,1,10,-9,D4,578
A,Argentina,3,6,6,3,3,A1,579
A,Canada,3,6,5,4,1,A2,579
A,Peru,3,3,3,4,-1,A3,579
A,Chile,3,3,2,5,-3,A4,579
B,Ecuador,3,6,5,2,3,B1,579
B,Venezuela,3,6,4,4,0,B2,579
B,Mexico,3,4,3,3,0,B3,579
B,Jamaica,3,1,1,4,-3,B4,579
C,Uruguay,3,7,3,0,3,C1,579
C,United States,3,6,4,1,3,C2,579
C,Panama,3,2,1,3,-2,C3,579
C,Bolivia,3,1,1,5,-4,C4,579
D,Colombia,3,9,7,1,6,D1,579
D,Brazil,3,6,5,1,4,D2,579
D,Paraguay,3,3,3,6,-3,D3,579
D,Costa Rica,3,0,0,7,-7,D4,579
A,Chile,3,6,5,5,0,A1,580
A,Peru,3,4,4,3,1,A2,580
A,Argentina,3,4,3,4,-1,A3,580
A,Canada,3,3,5,5,0,A4,580
B,Venezuela,3,7,6,2,4,B1,580
B,Mexico,3,5,5,3,2,B2,580
B,Ecuador,3,4,3,3,0,B3,580
B,Jamaica,3,0,1,7,-6,B4,580
C,Uruguay,3,7,4,1,3,C1,580
C,United States,3,6,4,3,1,C2,580
C,Panama,3,4,4,5,-1,C3,580
C,Bolivia,3,0,3,6,-3,C4,580
D,Brazil,3,9,8,0,8,D1,580
D,Colombia,3,6,2,1,1,D2,580
D,Costa Rica,3,1,2,6,-4,D3,580
D,Paraguay,3,1,2,7,-5,D4,580
A,Argentina,3,7,3,0,3,A1,581
A,Chile,3,6,2,2,0,A2,581
A,Peru,3,2,1,2,-1,A3,581
A,Canada,3,1,1,3,-2,A4,581
B,Ecuador,3,9,3,0,3,B1,581
B,Venezuela,3,6,6,2,4,B2,581
B,Mexico,3,3,2,4,-2,B3,581
B,Jamaica,3,0,2,7,-5,B4,581
C,Uruguay,3,7,9,3,6,C1,581
C,United States,3,6,6,5,1,C2,581
C,Bolivia,3,2,4,6,-2,C3,581
C,Panama,3,1,4,9,-5,C4,581
D,Brazil,3,7,5,1,4,D1,581
D,Paraguay,3,6,5,3,2,D2,581
D,Costa Rica,3,2,1,4,-3,D3,581
D,Colombia,3,1,1,4,-3,D4,581
A,Peru,3,9,5,1,4,A1,582
A,Argentina,3,4,4,5,-1,A2,582
A,Canada,3,3,2,3,-1,A3,582
A,Chile,3,1,3,5,-2,A4,582
B,Ecuador,3,6,7,4,3,B1,582
B,Mexico,3,4,5,5,0,B2,582
B,Venezuela,3,4,3,4,-1,B3,582
B,Jamaica,3,2,3,5,-2,B4,582
C,United States,3,7,5,2,3,C1,582
C,Panama,3,4,4,3,1,C2,582
C,Uruguay,3,3,4,4,0,C3,582
C,Bolivia,3,1,1,5,-4,C4,582
D,Costa Rica,3,5,3,1,2,D1,582
D,Colombia,3,3,3,3,0,D2,582
D,Brazil,3,3,2,2,0,D3,582
D,Paraguay,3,2,2,4,-2,D4,582
A,Argentina,3,9,9,2,7,A1,583
A,Chile,3,6,4,5,-1,A2,583
A,Canada,3,1,3,6,-3,A3,583
A,Peru,3,1,3,6,-3,A4,583
B,Ecuador,3,7,7,4,3,B1,583
B,Mexico,3,6,4,3,1,B2,583
B,Venezuela,3,3,6,6,0,B3,583
B,Jamaica,3,1,1,5,-4,B4,583
C,United States,3,7,8,5,3,C1,583
C,Uruguay,3,4,6,5,1,C2,583
C,Panama,3,3,1,4,-3,C3,583
C,Bolivia,3,2,3,4,-1,C4,583
D,Brazil,3,7,6,0,6,D1,583
D,Colombia,3,6,8,5,3,D2,583
D,Paraguay,3,2,1,3,-2,D3,583
D,Costa Rica,3,1,2,9,-7,D4,583
A,Argentina,3,7,10,1,9,A1,584
A,Peru,3,4,7,7,0,A2,584
A,Chile,3,3,3,3,0,A3,584
A,Canada,3,1,4,13,-9,A4,584
B,Mexico,3,5,6,4,2,B1,584
B,Ecuador,3,4,8,6,2,B2,584
B,Jamaica,3,4,3,5,-2,B3,584
B,Venezuela,3,3,2,4,-2,B4,584
C,United States,3,7,8,1,7,C1,584
C,Uruguay,3,5,4,2,2,C2,584
C,Bolivia,3,4,3,5,-2,C3,584
C,Panama,3,0,0,7,-7,C4,584
D,Colombia,3,7,4,1,3,D1,584
D,Brazil,3,6,4,2,2,D2,584
D,Paraguay,3,2,2,3,-1,D3,584
D,Costa Rica,3,1,0,4,-4,D4,584
A,Chile,3,9,4,0,4,A1,585
A,Argentina,3,6,4,1,3,A2,585
A,Peru,3,1,3,6,-3,A3,585
A,Canada,3,1,3,7,-4,A4,585
B,Ecuador,3,7,5,0,5,B1,585
B,Venezuela,3,4,4,5,-1,B2,585
B,Jamaica,3,2,3,5,-2,B3,585
B,Mexico,3,2,1,3,-2,B4,585
C,United States,3,7,4,2,2,C1,585
C,Uruguay,3,4,3,2,1,C2,585
C,Panama,3,4,1,1,0,C3,585
C,Bolivia,3,1,1,4,-3,C4,585
D,Brazil,3,9,5,1,4,D1,585
D,Costa Rica,3,4,4,5,-1,D2,585
D,Colombia,3,2,2,3,-1,D3,585
D,Paraguay,3,1,0,2,-2,D4,585
A,Argentina,3,9,9,0,9,A1,586
A,Chile,3,6,7,3,4,A2,586
A,Peru,3,1,1,7,-6,A3,586
A,Canada,3,1,1,8,-7,A4,586
B,Ecuador,3,6,7,4,3,B1,586
B,Mexico,3,6,6,4,2,B2,586
B,Venezuela,3,4,5,4,1,B3,586
B,Jamaica,3,1,2,8,-6,B4,586
C,Uruguay,3,5,4,3,1,C1,586
C,Bolivia,3,4,4,4,0,C2,586
C,United States,3,4,2,2,0,C3,586
C,Panama,3,3,2,3,-1,C4,586
D,Brazil,3,9,4,1,3,D1,586
D,Colombia,3,6,5,2,3,D2,586
D,Paraguay,3,1,1,3,-2,D3,586
D,Costa Rica,3,1,1,5,-4,D4,586
A,Argentina,3,7,6,1,5,A1,587
A,Canada,3,4,4,4,0,A2,587
A,Chile,3,4,2,2,0,A3,587
A,Peru,3,1,1,6,-5,A4,587
B,Mexico,3,7,5,1,4,B1,587
B,Ecuador,3,4,2,1,1,B2,587
B,Venezuela,3,3,4,4,0,B3,587
B,Jamaica,3,3,1,6,-5,B4,587
C,United States,3,9,7,2,5,C1,587
C,Uruguay,3,2,0,1,-1,C2,587
C,Bolivia,3,2,3,5,-2,C3,587
C,Panama,3,2,1,3,-2,C4,587
D,Brazil,3,7,5,1,4,D1,587
D,Colombia,3,6,5,2,3,D2,587
D,Costa Rica,3,3,1,4,-3,D3,587
D,Paraguay,3,1,0,4,-4,D4,587
A,Argentina,3,9,10,1,9,A1,588
A,Chile,3,4,1,3,-2,A2,588
A,Peru,3,3,1,4,-3,A3,588
A,Canada,3,1,1,5,-4,A4,588
B,Ecuador,3,7,7,3,4,B1,588
B,Venezuela,3,5,6,4,2,B2,588
B,Mexico,3,4,5,6,-1,B3,588
B,Jamaica,3,0,0,5,-5,B4,588
C,United States,3,7,4,2,2,C1,588
C,Uruguay,3,6,7,3,4,C2,588
C,Bolivia,3,4,5,6,-1,C3,588
C,Panama,3,0,0,5,-5,C4,588
D,Brazil,3,9,6,0,6,D1,588
D,Colombia,3,4,2,2,0,D2,588
D,Paraguay,3,3,3,5,-2,D3,588
D,Costa Rica,3,1,2,6,-4,D4,588
A,Canada,3,9,3,0,3,A1,589
A,Argentina,3,6,5,2,3,A2,589
A,Chile,3,3,2,5,-3,A3,589
A,Peru,3,0,0,3,-3,A4,589
B,Mexico,3,7,5,1,4,B1,589
B,Venezuela,3,6,5,5,0,B2,589
B,Ecuador,3,4,6,5,1,B3,589
B,Jamaica,3,0,4,9,-5,B4,589
C,United States,3,9,8,0,8,C1,589
C,Uruguay,3,6,4,3,1,C2,589
C,Bolivia,3,1,1,5,-4,C3,589
C,Panama,3,1,1,6,-5,C4,589
D,Brazil,3,9,5,1,4,D1,589
D,Colombia,3,4,3,2,1,D2,589
D,Paraguay,3,3,1,3,-2,D3,589
D,Costa Rica,3,1,0,3,-3,D4,589
A,Chile,3,7,6,1,5,A1,590
A,Argentina,3,5,2,0,2,A2,590
A,Peru,3,4,5,7,-2,A3,590
A,Canada,3,0,2,7,-5,A4,590
B,Venezuela,3,6,6,4,2,B1,590
B,Ecuador,3,4,5,5,0,B2,590
B,Mexico,3,4,2,3,-1,B3,590
B,Jamaica,3,2,4,5,-1,B4,590
C,United States,3,9,9,2,7,C1,590
C,Uruguay,3,6,4,1,3,C2,590
C,Bolivia,3,3,4,7,-3,C3,590
C,Panama,3,0,0,7,-7,C4,590
D,Brazil,3,7,6,2,4,D1,590
D,Colombia,3,5,2,1,1,D2,590
D,Paraguay,3,2,3,6,-3,D3,590
D,Costa Rica,3,1,0,2,-2,D4,590
A,Argentina,3,9,6,0,6,A1,591
A,Canada,3,6,3,1,2,A2,591
A,Chile,3,1,1,3,-2,A3,591
A,Peru,3,1,1,7,-6,A4,591
B,Ecuador,3,5,5,3,2,B1,591
B,Mexico,3,5,5,3,2,B2,591
B,Jamaica,3,2,2,4,-2,B3,591
B,Venezuela,3,2,0,2,-2,B4,591
C,United States,3,9,9,2,7,C1,591
C,Bolivia,3,6,5,7,-2,C2,591
C,Uruguay,3,1,2,4,-2,C3,591
C,Panama,3,1,3,6,-3,C4,591
D,Brazil,3,9,5,1,4,D1,591
D,Colombia,3,6,5,3,2,D2,591
D,Costa Rica,3,3,3,4,-1,D3,591
D,Paraguay,3,0,1,6,-5,D4,591
A,Argentina,3,7,6,2,4,A1,592
A,Canada,3,5,7,5,2,A2,592
A,Chile,3,3,1,4,-3,A3,592
A,Peru,3,1,3,6,-3,A4,592
B,Ecuador,3,5,7,5,2,B1,592
B,Mexico,3,4,5,5,0,B2,592
B,Venezuela,3,4,4,4,0,B3,592
B,Jamaica,3,3,5,7,-2,B4,592
C,Uruguay,3,5,4,2,2,C1,592
C,United States,3,5,3,1,2,C2,592
C,Bolivia,3,4,3,4,-1,C3,592
C,Panama,3,1,1,4,-3,C4,592
D,Brazil,3,9,6,0,6,D1,592
D,Colombia,3,4,3,2,1,D2,592
D,Costa Rica,3,4,2,3,-1,D3,592
D,Paraguay,3,0,1,7,-6,D4,592
A,Argentina,3,7,7,2,5,A1,593
A,Chile,3,7,2,0,2,A2,593
A,Peru,3,1,1,4,-3,A3,593
A,Canada,3,1,3,7,-4,A4,593
B,Ecuador,3,9,8,1,7,B1,593
B,Mexico,3,4,2,4,-2,B2,593
B,Venezuela,3,3,3,6,-3,B3,593
B,Jamaica,3,1,2,4,-2,B4,593
C,United States,3,7,4,1,3,C1,593
C,Uruguay,3,6,3,1,2,C2,593
C,Bolivia,3,4,2,3,-1,C3,593
C,Panama,3,0,0,4,-4,C4,593
D,Brazil,3,9,6,2,4,D1,593
D,Costa Rica,3,4,3,3,0,D2,593
D,Paraguay,3,4,3,3,0,D3,593
D,Colombia,3,0,1,5,-4,D4,593
A,Chile,3,7,7,3,4,A1,594
A,Peru,3,4,5,6,-1,A2,594
A,Argentina,3,3,5,6,-1,A3,594
A,Canada,3,3,4,6,-2,A4,594
B,Ecuador,3,7,9,1,8,B1,594
B,Mexico,3,4,1,1,0,B2,594
B,Jamaica,3,4,3,6,-3,B3,594
B,Venezuela,3,1,1,6,-5,B4,594
C,United States,3,7,5,1,4,C1,594
C,Uruguay,3,7,5,2,3,C2,594
C,Bolivia,3,3,2,4,-2,C3,594
C,Panama,3,0,2,7,-5,C4,594
D,Brazil,3,6,6,3,3,D1,594
D,Colombia,3,4,4,4,0,D2,594
D,Paraguay,3,4,4,4,0,D3,594
D,Costa Rica,3,2,2,5,-3,D4,594
A,Argentina,3,9,7,0,7,A1,595
A,Peru,3,4,3,6,-3,A2,595
A,Chile,3,3,2,3,-1,A3,595
A,Canada,3,1,1,4,-3,A4,595
B,Ecuador,3,9,4,1,3,B1,595
B,Mexico,3,4,3,2,1,B2,595
B,Jamaica,3,2,2,3,-1,B3,595
B,Venezuela,3,1,0,3,-3,B4,595
C,Uruguay,3,7,7,2,5,C1,595
C,United States,3,7,5,1,4,C2,595
C,Panama,3,3,4,5,-1,C3,595
C,Bolivia,3,0,1,9,-8,C4,595
D,Brazil,3,9,8,2,6,D1,595
D,Paraguay,3,6,5,7,-2,D2,595
D,Colombia,3,1,3,5,-2,D3,595
D,Costa Rica,3,1,2,4,-2,D4,595
A,Argentina,3,7,7,1,6,A1,596
A,Chile,3,4,4,3,1,A2,596
A,Peru,3,3,3,3,0,A3,596
A,Canada,3,3,2,9,-7,A4,596
B,Jamaica,3,7,4,2,2,B1,596
B,Ecuador,3,4,3,2,1,B2,596
B,Mexico,3,4,4,5,-1,B3,596
B,Venezuela,3,1,0,2,-2,B4,596
C,Uruguay,3,9,13,2,11,C1,596
C,United States,3,6,8,7,1,C2,596
C,Bolivia,3,3,2,9,-7,C3,596
C,Panama,3,0,4,9,-5,C4,596
D,Colombia,3,7,6,2,4,D1,596
D,Brazil,3,5,5,2,3,D2,596
D,Paraguay,3,3,4,8,-4,D3,596
D,Costa Rica,3,1,4,7,-3,D4,596
A,Peru,3,6,4,1,3,A1,597
A,Argentina,3,6,2,1,1,A2,597
A,Chile,3,6,2,3,-1,A3,597
A,Canada,3,0,0,3,-3,A4,597
B,Mexico,3,7,3,1,2,B1,597
B,Venezuela,3,5,4,3,1,B2,597
B,Jamaica,3,3,5,4,1,B3,597
B,Ecuador,3,1,0,4,-4,B4,597
C,Uruguay,3,7,4,1,3,C1,597
C,Panama,3,6,2,2,0,C2,597
C,United States,3,4,3,3,0,C3,597
C,Bolivia,3,0,3,6,-3,C4,597
D,Brazil,3,7,6,1,5,D1,597
D,Colombia,3,3,0,0,0,D2,597
D,Paraguay,3,2,2,3,-1,D3,597
D,Costa Rica,3,2,1,5,-4,D4,597
A,Argentina,3,7,4,2,2,A1,598
A,Peru,3,4,5,4,1,A2,598
A,Canada,3,4,1,2,-1,A3,598
A,Chile,3,1,1,3,-2,A4,598
B,Jamaica,3,9,4,0,4,B1,598
B,Venezuela,3,4,4,1,3,B2,598
B,Ecuador,3,3,4,6,-2,B3,598
B,Mexico,3,1,1,6,-5,B4,598
C,United States,3,7,3,1,2,C1,598
C,Uruguay,3,4,2,1,1,C2,598
C,Bolivia,3,4,1,1,0,C3,598
C,Panama,3,1,1,4,-3,C4,598
D,Brazil,3,6,5,2,3,D1,598
D,Colombia,3,6,3,2,1,D2,598
D,Paraguay,3,6,5,5,0,D3,598
D,Costa Rica,3,0,0,4,-4,D4,598
A,Argentina,3,7,4,1,3,A1,599
A,Canada,3,5,4,2,2,A2,599
A,Chile,3,4,3,4,-1,A3,599
A,Peru,3,0,1,5,-4,A4,599
B,Ecuador,3,7,7,1,6,B1,599
B,Jamaica,3,4,4,7,-3,B2,599
B,Mexico,3,3,6,5,1,B3,599
B,Venezuela,3,3,1,5,-4,B4,599
C,Uruguay,3,6,3,3,0,C1,599
C,United States,3,4,5,4,1,C2,599
C,Bolivia,3,4,5,5,0,C3,599
C,Panama,3,2,4,5,-1,C4,599
D,Brazil,3,9,8,1,7,D1,599
D,Costa Rica,3,6,3,1,2,D2,599
D,Colombia,3,3,3,4,-1,D3,599
D,Paraguay,3,0,0,8,-8,D4,599
A,Argentina,3,7,8,2,6,A1,600
A,Peru,3,3,3,3,0,A2,600
A,Chile,3,2,3,4,-1,A3,600
A,Canada,3,2,2,7,-5,A4,600
B,Mexico,3,9,9,2,7,B1,600
B,Ecuador,3,4,4,3,1,B2,600
B,Venezuela,3,2,2,4,-2,B3,600
B,Jamaica,3,1,1,7,-6,B4,600
C,United States,3,6,6,2,4,C1,600
C,Panama,3,4,3,3,0,C2,600
C,Uruguay,3,4,5,6,-1,C3,600
C,Bolivia,3,3,2,5,-3,C4,600
D,Brazil,3,9,7,1,6,D1,600
D,Colombia,3,6,4,4,0,D2,600
D,Paraguay,3,3,1,3,-2,D3,600
D,Costa Rica,3,0,2,6,-4,D4,600
A,Argentina,3,7,6,3,3,A1,601
A,Chile,3,4,2,3,-1,A2,601
A,Canada,3,3,2,3,-1,A3,601
A,Peru,3,2,3,4,-1,A4,601
B,Ecuador,3,6,5,2,3,B1,601
B,Mexico,3,6,4,1,3,B2,601
B,Venezuela,3,4,2,2,0,B3,601
B,Jamaica,3,1,1,7,-6,B4,601
C,United States,3,7,6,3,3,C1,601
C,Uruguay,3,5,4,2,2,C2,601
C,Bolivia,3,3,3,5,-2,C3,601
C,Panama,3,1,2,5,-3,C4,601
D,Brazil,3,7,5,1,4,D1,601
D,Colombia,3,5,4,2,2,D2,601
D,Paraguay,3,4,4,4,0,D3,601
D,Costa Rica,3,0,2,8,-6,D4,601
A,Argentina,3,7,5,0,5,A1,602
A,Canada,3,4,3,3,0,A2,602
A,Chile,3,4,4,6,-2,A3,602
A,Peru,3,1,0,3,-3,A4,602
B,Ecuador,3,7,3,1,2,B1,602
B,Mexico,3,6,6,5,1,B2,602
B,Venezuela,3,2,5,6,-1,B3,602
B,Jamaica,3,1,4,6,-2,B4,602
C,Uruguay,3,9,9,0,9,C1,602
C,United States,3,6,6,3,3,C2,602
C,Panama,3,3,1,6,-5,C3,602
C,Bolivia,3,0,0,7,-7,C4,602
D,Brazil,3,7,3,1,2,D1,602
D,Costa Rica,3,6,2,1,1,D2,602
D,Paraguay,3,2,1,2,-1,D3,602
D,Colombia,3,1,0,2,-2,D4,602
A,Chile,3,9,4,0,4,A1,603
A,Canada,3,3,3,3,0,A2,603
A,Argentina,3,3,2,4,-2,A3,603
A,Peru,3,3,1,3,-2,A4,603
B,Ecuador,3,7,9,4,5,B1,603
B,Venezuela,3,4,2,4,-2,B2,603
B,Mexico,3,3,6,6,0,B3,603
B,Jamaica,3,1,2,5,-3,B4,603
C,Bolivia,3,7,7,3,4,C1,603
C,Panama,3,6,9,6,3,C2,603
C,United States,3,3,4,7,-3,C3,603
C,Uruguay,3,1,3,7,-4,C4,603
D,Brazil,3,7,7,2,5,D1,603
D,Paraguay,3,5,4,1,3,D2,603
D,Colombia,3,4,3,4,-1,D3,603
D,Costa Rica,3,0,3,10,-7,D4,603
A,Peru,3,6,9,4,5,A1,604
A,Chile,3,5,3,2,1,A2,604
A,Argentina,3,4,5,4,1,A3,604
A,Canada,3,1,0,7,-7,A4,604
B,Ecuador,3,9,10,3,7,B1,604
B,Jamaica,3,2,2,3,-1,B2,604
B,Venezuela,3,2,3,6,-3,B3,604
B,Mexico,3,2,2,5,-3,B4,604
C,Uruguay,3,6,3,3,0,C1,604
C,United States,3,4,3,2,1,C2,604
C,Bolivia,3,4,5,5,0,C3,604
C,Panama,3,3,5,6,-1,C4,604
D,Brazil,3,7,5,1,4,D1,604
D,Colombia,3,6,4,3,1,D2,604
D,Costa Rica,3,2,1,3,-2,D3,604
D,Paraguay,3,1,0,3,-3,D4,604
A,Chile,3,7,4,0,4,A1,605
A,Peru,3,4,3,3,0,A2,605
A,Canada,3,4,4,5,-1,A3,605
A,Argentina,3,1,3,6,-3,A4,605
B,Mexico,3,7,8,2,6,B1,605
B,Ecuador,3,6,5,4,1,B2,605
B,Venezuela,3,3,3,7,-4,B3,605
B,Jamaica,3,1,2,5,-3,B4,605
C,United States,3,9,5,2,3,C1,605
C,Uruguay,3,6,8,1,7,C2,605
C,Bolivia,3,3,3,4,-1,C3,605
C,Panama,3,0,1,10,-9,C4,605
D,Colombia,3,7,2,0,2,D1,605
D,Paraguay,3,6,6,3,3,D2,605
D,Brazil,3,4,2,3,-1,D3,605
D,Costa Rica,3,0,1,5,-4,D4,605
A,Chile,3,7,5,2,3,A1,606
A,Argentina,3,4,7,3,4,A2,606
A,Peru,3,4,2,3,-1,A3,606
A,Canada,3,1,3,9,-6,A4,606
B,Mexico,3,7,11,2,9,B1,606
B,Venezuela,3,6,5,5,0,B2,606
B,Ecuador,3,4,2,2,0,B3,606
B,Jamaica,3,0,0,9,-9,B4,606
C,Uruguay,3,7,9,3,6,C1,606
C,United States,3,7,5,2,3,C2,606
C,Panama,3,3,5,4,1,C3,606
C,Bolivia,3,0,1,11,-10,C4,606
D,Brazil,3,9,7,0,7,D1,606
D,Paraguay,3,6,4,3,1,D2,606
D,Costa Rica,3,3,1,4,-3,D3,606
D,Colombia,3,0,0,5,-5,D4,606
A,Argentina,3,6,7,3,4,A1,607
A,Peru,3,4,3,3,0,A2,607
A,Chile,3,4,4,6,-2,A3,607
A,Canada,3,3,2,4,-2,A4,607
B,Mexico,3,5,7,2,5,B1,607
B,Ecuador,3,4,6,6,0,B2,607
B,Jamaica,3,4,3,7,-4,B3,607
B,Venezuela,3,2,5,6,-1,B4,607
C,United States,3,9,4,1,3,C1,607
C,Panama,3,4,5,2,3,C2,607
C,Uruguay,3,4,4,3,1,C3,607
C,Bolivia,3,0,2,9,-7,C4,607
D,Brazil,3,7,6,2,4,D1,607
D,Colombia,3,6,5,4,1,D2,607
D,Costa Rica,3,3,2,4,-2,D3,607
D,Paraguay,3,1,2,5,-3,D4,607
A,Canada,3,7,7,2,5,A1,608
A,Chile,3,4,3,4,-1,A2,608
A,Peru,3,3,2,5,-3,A3,608
A,Argentina,3,2,2,3,-1,A4,608
B,Mexico,3,4,2,1,1,B1,608
B,Ecuador,3,4,2,2,0,B2,608
B,Jamaica,3,4,2,3,-1,B3,608
B,Venezuela,3,3,0,0,0,B4,608
C,Bolivia,3,6,6,3,3,C1,608
C,Panama,3,4,3,4,-1,C2,608
C,United States,3,4,4,6,-2,C3,608
C,Uruguay,3,3,4,4,0,C4,608
D,Colombia,3,9,5,0,5,D1,608
D,Brazil,3,6,5,2,3,D2,608
D,Costa Rica,3,3,1,4,-3,D3,608
D,Paraguay,3,0,0,5,-5,D4,608
A,Argentina,3,7,6,2,4,A1,609
A,Canada,3,6,5,4,1,A2,609
A,Peru,3,3,1,4,-3,A3,609
A,Chile,3,1,2,4,-2,A4,609
B,Mexico,3,9,7,1,6,B1,609
B,Ecuador,3,6,5,2,3,B2,609
B,Jamaica,3,1,3,7,-4,B3,609
B,Venezuela,3,1,3,8,-5,B4,609
C,United States,3,6,6,2,4,C1,609
C,Uruguay,3,5,4,3,1,C2,609
C,Panama,3,4,4,5,-1,C3,609
C,Bolivia,3,1,3,7,-4,C4,609
D,Brazil,3,5,4,2,2,D1,609
D,Paraguay,3,5,4,2,2,D2,609
D,Colombia,3,5,3,2,1,D3,609
D,Costa Rica,3,0,0,5,-5,D4,609
A,Argentina,3,7,4,2,2,A1,610
A,Canada,3,6,4,2,2,A2,610
A,Chile,3,4,7,5,2,A3,610
A,Peru,3,0,1,7,-6,A4,610
B,Ecuador,3,7,5,2,3,B1,610
B,Mexico,3,5,5,3,2,B2,610
B,Venezuela,3,2,1,3,-2,B3,610
B,Jamaica,3,1,2,5,-3,B4,610
C,Uruguay,3,9,12,1,11,C1,610
C,Panama,3,4,2,5,-3,C2,610
C,Bolivia,3,2,4,6,-2,C3,610
C,United States,3,1,2,8,-6,C4,610
D,Brazil,3,9,9,0,9,D1,610
D,Paraguay,3,3,3,4,-1,D2,610
D,Colombia,3,3,3,5,-2,D3,610
D,Costa Rica,3,3,3,9,-6,D4,610
A,Peru,3,5,5,3,2,A1,611
A,Argentina,3,4,6,4,2,A2,611
A,Chile,3,4,2,3,-1,A3,611
A,Canada,3,2,1,4,-3,A4,611
B,Venezuela,3,7,4,1,3,B1,611
B,Ecuador,3,6,7,5,2,B2,611
B,Mexico,3,4,2,2,0,B3,611
B,Jamaica,3,0,2,7,-5,B4,611
C,United States,3,5,5,4,1,C1,611
C,Panama,3,3,5,5,0,C2,611
C,Uruguay,3,3,5,5,0,C3,611
C,Bolivia,3,2,2,3,-1,C4,611
D,Brazil,3,7,6,0,6,D1,611
D,Colombia,3,5,4,2,2,D2,611
D,Costa Rica,3,3,3,4,-1,D3,611
D,Paraguay,3,1,2,9,-7,D4,611
A,Argentina,3,9,5,1,4,A1,612
A,Peru,3,4,2,2,0,A2,612
A,Chile,3,4,3,4,-1,A3,612
A,Canada,3,0,4,7,-3,A4,612
B,Mexico,3,6,6,4,2,B1,612
B,Ecuador,3,4,7,5,2,B2,612
B,Jamaica,3,4,4,4,0,B3,612
B,Venezuela,3,3,4,8,-4,B4,612
C,Uruguay,3,7,4,1,3,C1,612
C,Panama,3,6,5,2,3,C2,612
C,United States,3,3,3,5,-2,C3,612
C,Bolivia,3,1,2,6,-4,C4,612
D,Paraguay,3,6,6,2,4,D1,612
D,Brazil,3,6,6,5,1,D2,612
D,Colombia,3,4,3,3,0,D3,612
D,Costa Rica,3,1,1,6,-5,D4,612
A,Argentina,3,7,7,2,5,A1,613
A,Chile,3,5,2,1,1,A2,613
A,Peru,3,3,2,6,-4,A3,613
A,Canada,3,1,2,4,-2,A4,613
B,Jamaica,3,6,5,4,1,B1,613
B,Venezuela,3,5,2,1,1,B2,613
B,Mexico,3,4,3,1,2,B3,613
B,Ecuador,3,1,4,8,-4,B4,613
C,Panama,3,7,6,4,2,C1,613
C,Uruguay,3,4,3,3,0,C2,613
C,Bolivia,3,3,3,4,-1,C3,613
C,United States,3,3,3,4,-1,C4,613
D,Brazil,3,9,7,0,7,D1,613
D,Colombia,3,4,3,2,1,D2,613
D,Costa Rica,3,3,2,4,-2,D3,613
D,Paraguay,3,1,2,8,-6,D4,613
A,Chile,3,9,5,0,5,A1,614
A,Argentina,3,4,1,1,0,A2,614
A,Canada,3,4,1,3,-2,A3,614
A,Peru,3,0,0,3,-3,A4,614
B,Mexico,3,7,8,3,5,B1,614
B,Venezuela,3,6,4,3,1,B2,614
B,Ecuador,3,2,4,6,-2,B3,614
B,Jamaica,3,1,2,6,-4,B4,614
C,Uruguay,3,7,5,2,3,C1,614
C,Panama,3,5,4,2,2,C2,614
C,Bolivia,3,4,4,5,-1,C3,614
C,United States,3,0,5,9,-4,C4,614
D,Brazil,3,9,10,1,9,D1,614
D,Paraguay,3,4,3,2,1,D2,614
D,Colombia,3,2,1,2,-1,D3,614
D,Costa Rica,3,1,0,9,-9,D4,614
A,Argentina,3,9,6,2,4,A1,615
A,Peru,3,4,3,4,-1,A2,615
A,Chile,3,2,2,3,-1,A3,615
A,Canada,3,1,2,4,-2,A4,615
B,Mexico,3,9,11,1,10,B1,615
B,Ecuador,3,4,6,5,1,B2,615
B,Venezuela,3,2,5,7,-2,B3,615
B,Jamaica,3,1,3,12,-9,B4,615
C,Bolivia,3,6,4,3,1,C1,615
C,Uruguay,3,6,3,2,1,C2,615
C,Panama,3,4,1,1,0,C3,615
C,United States,3,1,1,3,-2,C4,615
D,Brazil,3,6,6,2,4,D1,615
D,Colombia,3,6,6,3,3,D2,615
D,Paraguay,3,6,4,3,1,D3,615
D,Costa Rica,3,0,0,8,-8,D4,615
A,Argentina,3,7,8,2,6,A1,616
A,Chile,3,7,7,2,5,A2,616
A,Peru,3,3,3,2,1,A3,616
A,Canada,3,0,4,16,-12,A4,616
B,Mexico,3,9,6,1,5,B1,616
B,Ecuador,3,4,2,2,0,B2,616
B,Jamaica,3,2,3,5,-2,B3,616
B,Venezuela,3,1,3,6,-3,B4,616
C,United States,3,7,7,4,3,C1,616
C,Bolivia,3,6,6,3,3,C2,616
C,Uruguay,3,3,2,5,-3,C3,616
C,Panama,3,1,5,8,-3,C4,616
D,Brazil,3,9,9,0,9,D1,616
D,Colombia,3,6,4,4,0,D2,616
D,Paraguay,3,3,6,6,0,D3,616
D,Costa Rica,3,0,3,12,-9,D4,616
A,Argentina,3,5,5,4,1,A1,617
A,Canada,3,5,3,2,1,A2,617
A,Chile,3,5,2,1,1,A3,617
A,Peru,3,0,3,6,-3,A4,617
B,Ecuador,3,6,8,2,6,B1,617
B,Mexico,3,6,4,1,3,B2,617
B,Jamaica,3,3,1,5,-4,B3,617
B,Venezuela,3,3,3,8,-5,B4,617
C,United States,3,9,9,2,7,C1,617
C,Bolivia,3,4,4,5,-1,C2,617
C,Uruguay,3,3,3,5,-2,C3,617
C,Panama,3,1,2,6,-4,C4,617
D,Brazil,3,7,4,2,2,D1,617
D,Colombia,3,6,3,2,1,D2,617
D,Paraguay,3,3,1,2,-1,D3,617
D,Costa Rica,3,1,1,3,-2,D4,617
A,Argentina,3,6,5,3,2,A1,618
A,Peru,3,5,4,2,2,A2,618
A,Chile,3,2,3,4,-1,A3,618
A,Canada,3,2,2,5,-3,A4,618
B,Mexico,3,7,6,4,2,B1,618
B,Ecuador,3,6,11,6,5,B2,618
B,Jamaica,3,4,3,3,0,B3,618
B,Venezuela,3,0,2,9,-7,B4,618
C,United States,3,6,7,3,4,C1,618
C,Uruguay,3,6,5,2,3,C2,618
C,Bolivia,3,6,4,5,-1,C3,618
C,Panama,3,0,2,8,-6,C4,618
D,Brazil,3,9,7,0,7,D1,618
D,Colombia,3,3,1,2,-1,D2,618
D,Paraguay,3,3,3,5,-2,D3,618
D,Costa Rica,3,3,2,6,-4,D4,618
A,Peru,3,7,5,3,2,A1,619
A,Argentina,3,6,6,4,2,A2,619
A,Canada,3,3,3,5,-2,A3,619
A,Chile,3,1,4,6,-2,A4,619
B,Mexico,3,7,5,2,3,B1,619
B,Jamaica,3,4,4,4,0,B2,619
B,Ecuador,3,4,3,3,0,B3,619
B,Venezuela,3,1,1,4,-3,B4,619
C,United States,3,7,5,0,5,C1,619
C,Uruguay,3,7,6,4,2,C2,619
C,Panama,3,3,3,5,-2,C3,619
C,Bolivia,3,0,2,7,-5,C4,619
D,Brazil,3,5,2,1,1,D1,619
D,Colombia,3,4,3,2,1,D2,619
D,Paraguay,3,4,4,4,0,D3,619
D,Costa Rica,3,2,2,4,-2,D4,619
A,Argentina,3,5,5,2,3,A1,620
A,Chile,3,5,5,4,1,A2,620
A,Peru,3,3,2,2,0,A3,620
A,Canada,3,1,4,8,-4,A4,620
B,Mexico,3,5,5,2,3,B1,620
B,Ecuador,3,4,3,2,1,B2,620
B,Venezuela,3,4,2,3,-1,B3,620
B,Jamaica,3,3,1,4,-3,B4,620
C,United States,3,7,6,2,4,C1,620
C,Uruguay,3,4,5,4,1,C2,620
C,Bolivia,3,3,2,4,-2,C3,620
C,Panama,3,3,1,4,-3,C4,620
D,Brazil,3,6,9,3,6,D1,620
D,Colombia,3,4,2,2,0,D2,620
D,Paraguay,3,4,4,6,-2,D3,620
D,Costa Rica,3,3,4,8,-4,D4,620
A,Argentina,3,7,5,2,3,A1,621
A,Chile,3,4,4,4,0,A2,621
A,Canada,3,3,3,3,0,A3,621
A,Peru,3,1,2,5,-3,A4,621
B,Mexico,3,6,4,2,2,B1,621
B,Ecuador,3,4,3,3,0,B2,621
B,Venezuela,3,4,3,4,-1,B3,621
B,Jamaica,3,2,3,4,-1,B4,621
C,United States,3,7,3,1,2,C1,621
C,Panama,3,5,2,1,1,C2,621
C,Bolivia,3,2,3,4,-1,C3,621
C,Uruguay,3,1,3,5,-2,C4,621
D,Brazil,3,9,10,5,5,D1,621
D,Colombia,3,6,4,3,1,D2,621
D,Paraguay,3,1,4,7,-3,D3,621
D,Costa Rica,3,1,3,6,-3,D4,621
A,Argentina,3,9,6,1,5,A1,622
A,Peru,3,4,3,2,1,A2,622
A,Chile,3,2,3,4,-1,A3,622
A,Canada,3,1,1,6,-5,A4,622
B,Ecuador,3,6,6,5,1,B1,622
B,Mexico,3,5,4,3,1,B2,622
B,Jamaica,3,4,3,3,0,B3,622
B,Venezuela,3,1,1,3,-2,B4,622
C,United States,3,9,10,1,9,C1,622
C,Uruguay,3,6,5,3,2,C2,622
C,Panama,3,1,1,4,-3,C3,622
C,Bolivia,3,1,1,9,-8,C4,622
D,Brazil,3,7,7,2,5,D1,622
D,Colombia,3,5,4,1,3,D2,622
D,Costa Rica,3,3,2,7,-5,D3,622
D,Paraguay,3,1,2,5,-3,D4,622
A,Argentina,3,7,5,2,3,A1,623
A,Chile,3,5,5,4,1,A2,623
A,Peru,3,3,4,5,-1,A3,623
A,Canada,3,1,4,7,-3,A4,623
B,Ecuador,3,7,5,2,3,B1,623
B,Mexico,3,4,3,2,1,B2,623
B,Jamaica,3,3,4,5,-1,B3,623
B,Venezuela,3,3,3,6,-3,B4,623
C,United States,3,6,8,5,3,C1,623
C,Uruguay,3,6,5,4,1,C2,623
C,Panama,3,6,6,7,-1,C3,623
C,Bolivia,3,0,3,6,-3,C4,623
D,Brazil,3,7,6,1,5,D1,623
D,Colombia,3,5,5,2,3,D2,623
D,Costa Rica,3,3,2,7,-5,D3,623
D,Paraguay,3,1,2,5,-3,D4,623
A,Argentina,3,9,9,1,8,A1,624
A,Canada,3,6,3,5,-2,A2,624
A,Chile,3,3,3,3,0,A3,624
A,Peru,3,0,0,6,-6,A4,624
B,Ecuador,3,9,10,2,8,B1,624
B,Mexico,3,6,5,3,2,B2,624
B,Venezuela,3,3,3,6,-3,B3,624
B,Jamaica,3,0,0,7,-7,B4,624
C,Uruguay,3,6,4,2,2,C1,624
C,Panama,3,6,4,3,1,C2,624
C,United States,3,3,3,4,-1,C3,624
C,Bolivia,3,3,2,4,-2,C4,624
D,Colombia,3,6,6,4,2,D1,624
D,Paraguay,3,6,6,7,-1,D2,624
D,Brazil,3,4,8,6,2,D3,624
D,Costa Rica,3,1,3,6,-3,D4,624
A,Canada,3,6,2,4,-2,A1,625
A,Argentina,3,5,5,1,4,A2,625
A,Chile,3,2,1,2,-1,A3,625
A,Peru,3,2,0,1,-1,A4,625
B,Venezuela,3,6,3,3,0,B1,625
B,Ecuador,3,4,2,1,1,B2,625
B,Mexico,3,4,2,2,0,B3,625
B,Jamaica,3,2,0,1,-1,B4,625
C,United States,3,5,4,1,3,C1,625
C,Uruguay,3,5,3,2,1,C2,625
C,Bolivia,3,4,3,3,0,C3,625
C,Panama,3,1,1,5,-4,C4,625
D,Brazil,3,5,4,3,1,D1,625
D,Costa Rica,3,4,3,3,0,D2,625
D,Paraguay,3,4,2,2,0,D3,625
D,Colombia,3,3,1,2,-1,D4,625
A,Chile,3,7,4,1,3,A1,626
A,Argentina,3,4,5,4,1,A2,626
A,Peru,3,4,3,3,0,A3,626
A,Canada,3,1,2,6,-4,A4,626
B,Ecuador,3,7,7,3,4,B1,626
B,Mexico,3,6,5,2,3,B2,626
B,Venezuela,3,4,4,6,-2,B3,626
B,Jamaica,3,0,2,7,-5,B4,626
C,United States,3,7,8,4,4,C1,626
C,Panama,3,4,4,4,0,C2,626
C,Uruguay,3,3,3,3,0,C3,626
C,Bolivia,3,1,2,6,-4,C4,626
D,Colombia,3,7,4,1,3,D1,626
D,Brazil,3,5,4,3,1,D2,626
D,Costa Rica,3,2,4,5,-1,D3,626
D,Paraguay,3,1,2,5,-3,D4,626
A,Argentina,3,7,6,2,4,A1,627
A,Chile,3,5,4,2,2,A2,627
A,Canada,3,2,4,7,-3,A3,627
A,Peru,3,1,2,5,-3,A4,627
B,Venezuela,3,5,5,3,2,B1,627
B,Ecuador,3,5,6,5,1,B2,627
B,Mexico,3,5,4,3,1,B3,627
B,Jamaica,3,0,1,5,-4,B4,627
C,Uruguay,3,9,9,2,7,C1,627
C,United States,3,3,4,4,0,C2,627
C,Bolivia,3,3,4,6,-2,C3,627
C,Panama,3,3,3,8,-5,C4,627
D,Brazil,3,5,3,2,1,D1,627
D,Paraguay,3,5,1,0,1,D2,627
D,Colombia,3,4,5,3,2,D3,627
D,Costa Rica,3,1,2,6,-4,D4,627
A,Argentina,3,6,9,1,8,A1,628
A,Chile,3,6,4,5,-1,A2,628
A,Peru,3,4,4,4,0,A3,628
A,Canada,3,1,2,9,-7,A4,628
B,Venezuela,3,5,4,2,2,B1,628
B,Ecuador,3,4,2,2,0,B2,628
B,Mexico,3,4,2,2,0,B3,628
B,Jamaica,3,3,1,3,-2,B4,628
C,United States,3,7,6,2,4,C1,628
C,Panama,3,6,4,3,1,C2,628
C,Uruguay,3,4,8,3,5,C3,628
C,Bolivia,3,0,1,11,-10,C4,628
D,Brazil,3,5,6,2,4,D1,628
D,Costa Rica,3,4,3,6,-3,D2,628
D,Colombia,3,3,3,3,0,D3,628
D,Paraguay,3,2,3,4,-1,D4,628
A,Peru,3,7,6,4,2,A1,629
A,Argentina,3,6,6,4,2,A2,629
A,Canada,3,3,5,6,-1,A3,629
A,Chile,3,1,5,8,-3,A4,629
B,Ecuador,3,4,3,3,0,B1,629
B,Mexico,3,4,3,3,0,B2,629
B,Jamaica,3,4,1,1,0,B3,629
B,Venezuela,3,3,2,2,0,B4,629
C,United States,3,9,5,0,5,C1,629
C,Uruguay,3,6,3,2,1,C2,629
C,Bolivia,3,1,2,5,-3,C3,629
C,Panama,3,1,2,5,-3,C4,629
D,Brazil,3,9,6,2,4,D1,629
D,Colombia,3,4,4,3,1,D2,629
D,Costa Rica,3,4,3,3,0,D3,629
D,Paraguay,3,0,0,5,-5,D4,629
A,Chile,3,7,4,1,3,A1,630
A,Argentina,3,5,4,1,3,A2,630
A,Canada,3,3,2,4,-2,A3,630
A,Peru,3,1,2,6,-4,A4,630
B,Ecuador,3,9,7,0,7,B1,630
B,Mexico,3,4,5,2,3,B2,630
B,Venezuela,3,4,6,4,2,B3,630
B,Jamaica,3,0,2,14,-12,B4,630
C,United States,3,6,4,4,0,C1,630
C,Uruguay,3,4,3,2,1,C2,630
C,Bolivia,3,4,5,5,0,C3,630
C,Panama,3,2,4,5,-1,C4,630
D,Colombia,3,7,4,1,3,D1,630
D,Brazil,3,6,9,3,6,D2,630
D,Costa Rica,3,4,2,5,-3,D3,630
D,Paraguay,3,0,2,8,-6,D4,630
A,Argentina,3,6,4,2,2,A1,631
A,Chile,3,6,4,3,1,A2,631
A,Peru,3,3,3,3,0,A3,631
A,Canada,3,3,4,7,-3,A4,631
B,Ecuador,3,7,4,0,4,B1,631
B,Mexico,3,4,5,2,3,B2,631
B,Jamaica,3,4,2,4,-2,B3,631
B,Venezuela,3,1,0,5,-5,B4,631
C,Uruguay,3,9,10,2,8,C1,631
C,United States,3,6,7,6,1,C2,631
C,Bolivia,3,3,5,7,-2,C3,631
C,Panama,3,0,0,7,-7,C4,631
D,Brazil,3,9,4,0,4,D1,631
D,Colombia,3,6,4,2,2,D2,631
D,Costa Rica,3,3,1,3,-2,D3,631
D,Paraguay,3,0,1,5,-4,D4,631
A,Argentina,3,7,7,4,3,A1,632
A,Canada,3,4,5,4,1,A2,632
A,Chile,3,3,4,5,-1,A3,632
A,Peru,3,3,3,6,-3,A4,632
B,Jamaica,3,5,3,2,1,B1,632
B,Ecuador,3,5,2,1,1,B2,632
B,Mexico,3,2,3,4,-1,B3,632
B,Venezuela,3,2,2,3,-1,B4,632
C,Uruguay,3,7,5,3,2,C1,632
C,Bolivia,3,4,4,4,0,C2,632
C,Panama,3,4,3,3,0,C3,632
C,United States,3,1,4,6,-2,C4,632
D,Brazil,3,7,7,1,6,D1,632
D,Colombia,3,5,3,0,3,D2,632
D,Costa Rica,3,3,4,10,-6,D3,632
D,Paraguay,3,1,4,7,-3,D4,632
A,Argentina,3,7,3,0,3,A1,633
A,Chile,3,6,3,3,0,A2,633
A,Canada,3,4,1,1,0,A3,633
A,Peru,3,0,1,4,-3,A4,633
B,Mexico,3,9,8,0,8,B1,633
B,Venezuela,3,4,3,5,-2,B2,633
B,Ecuador,3,3,2,3,-1,B3,633
B,Jamaica,3,1,1,6,-5,B4,633
C,Uruguay,3,9,6,1,5,C1,633
C,Bolivia,3,3,3,4,-1,C2,633
C,United States,3,3,2,3,-1,C3,633
C,Panama,3,3,1,4,-3,C4,633
D,Brazil,3,7,11,1,10,D1,633
D,Paraguay,3,6,5,6,-1,D2,633
D,Colombia,3,4,3,4,-1,D3,633
D,Costa Rica,3,0,2,10,-8,D4,633
A,Argentina,3,5,5,2,3,A1,634
A,Chile,3,4,3,4,-1,A2,634
A,Peru,3,3,3,3,0,A3,634
A,Canada,3,2,2,4,-2,A4,634
B,Mexico,3,4,8,5,3,B1,634
B,Venezuela,3,4,4,4,0,B2,634
B,Jamaica,3,4,5,6,-1,B3,634
B,Ecuador,3,4,7,9,-2,B4,634
C,United States,3,9,10,1,9,C1,634
C,Uruguay,3,6,6,4,2,C2,634
C,Bolivia,3,3,3,6,-3,C3,634
C,Panama,3,0,1,9,-8,C4,634
D,Brazil,3,7,5,2,3,D1,634
D,Colombia,3,6,7,3,4,D2,634
D,Paraguay,3,4,3,4,-1,D3,634
D,Costa Rica,3,0,0,6,-6,D4,634
A,Argentina,3,9,8,1,7,A1,635
A,Peru,3,2,0,1,-1,A2,635
A,Chile,3,2,2,5,-3,A3,635
A,Canada,3,2,1,4,-3,A4,635
B,Mexico,3,7,6,3,3,B1,635
B,Jamaica,3,6,3,3,0,B2,635
B,Ecuador,3,2,3,4,-1,B3,635
B,Venezuela,3,1,3,5,-2,B4,635
C,United States,3,7,10,3,7,C1,635
C,Panama,3,4,5,5,0,C2,635
C,Bolivia,3,3,3,9,-6,C3,635
C,Uruguay,3,2,4,5,-1,C4,635
D,Brazil,3,7,5,0,5,D1,635
D,Colombia,3,7,5,0,5,D2,635
D,Costa Rica,3,3,1,6,-5,D3,635
D,Paraguay,3,0,0,5,-5,D4,635
A,Canada,3,7,6,4,2,A1,636
A,Chile,3,5,5,2,3,A2,636
A,Peru,3,2,3,4,-1,A3,636
A,Argentina,3,1,3,7,-4,A4,636
B,Ecuador,3,7,5,1,4,B1,636
B,Mexico,3,7,3,1,2,B2,636
B,Venezuela,3,1,2,4,-2,B3,636
B,Jamaica,3,1,2,6,-4,B4,636
C,Uruguay,3,7,4,2,2,C1,636
C,United States,3,6,4,2,2,C2,636
C,Bolivia,3,2,3,5,-2,C3,636
C,Panama,3,1,2,4,-2,C4,636
D,Paraguay,3,9,4,1,3,D1,636
D,Colombia,3,4,3,3,0,D2,636
D,Brazil,3,4,2,2,0,D3,636
D,Costa Rica,3,0,0,3,-3,D4,636
A,Argentina,3,7,4,2,2,A1,637
A,Chile,3,7,2,0,2,A2,637
A,Peru,3,1,2,4,-2,A3,637
A,Canada,3,1,0,2,-2,A4,637
B,Mexico,3,7,5,1,4,B1,637
B,Ecuador,3,5,4,3,1,B2,637
B,Jamaica,3,3,5,5,0,B3,637
B,Venezuela,3,1,0,5,-5,B4,637
C,United States,3,9,7,1,6,C1,637
C,Uruguay,3,6,6,3,3,C2,637
C,Panama,3,1,2,6,-4,C3,637
C,Bolivia,3,1,1,6,-5,C4,637
D,Brazil,3,9,6,1,5,D1,637
D,Colombia,3,6,4,1,3,D2,637
D,Paraguay,3,1,2,6,-4,D3,637
D,Costa Rica,3,1,1,5,-4,D4,637
A,Argentina,3,7,9,2,7,A1,638
A,Canada,3,7,7,4,3,A2,638
A,Peru,3,3,2,5,-3,A3,638
A,Chile,3,0,2,9,-7,A4,638
B,Ecuador,3,9,7,2,5,B1,638
B,Mexico,3,4,4,2,2,B2,638
B,Jamaica,3,3,5,9,-4,B3,638
B,Venezuela,3,1,1,4,-3,B4,638
C,Bolivia,3,6,4,3,1,C1,638
C,Uruguay,3,6,3,2,1,C2,638
C,United States,3,3,2,3,-1,C3,638
C,Panama,3,3,1,2,-1,C4,638
D,Paraguay,3,5,1,0,1,D1,638
D,Colombia,3,4,4,3,1,D2,638
D,Costa Rica,3,4,2,3,-1,D3,638
D,Brazil,3,2,3,4,-1,D4,638
A,Argentina,3,9,8,0,8,A1,639
A,Canada,3,4,3,7,-4,A2,639
A,Chile,3,2,1,2,-1,A3,639
A,Peru,3,1,1,4,-3,A4,639
B,Venezuela,3,6,6,4,2,B1,639
B,Mexico,3,6,7,6,1,B2,639
B,Jamaica,3,3,2,3,-1,B3,639
B,Ecuador,3,3,6,8,-2,B4,639
C,United States,3,6,9,2,7,C1,639
C,Bolivia,3,6,7,6,1,C2,639
C,Uruguay,3,6,6,6,0,C3,639
C,Panama,3,0,2,10,-8,C4,639
D,Colombia,3,7,6,3,3,D1,639
D,Brazil,3,6,5,2,3,D2,639
D,Costa Rica,3,2,6,7,-1,D3,639
D,Paraguay,3,1,3,8,-5,D4,639
A,Argentina,3,6,8,4,4,A1,640
A,Chile,3,6,4,5,-1,A2,640
A,Peru,3,4,2,1,1,A3,640
A,Canada,3,1,0,4,-4,A4,640
B,Mexico,3,7,5,2,3,B1,640
B,Jamaica,3,4,5,6,-1,B2,640
B,Ecuador,3,3,4,4,0,B3,640
B,Venezuela,3,2,4,6,-2,B4,640
C,United States,3,9,6,2,4,C1,640
C,Panama,3,4,2,2,0,C2,640
C,Uruguay,3,4,2,3,-1,C3,640
C,Bolivia,3,0,4,7,-3,C4,640
D,Brazil,3,6,9,3,6,D1,640
D,Costa Rica,3,4,3,4,-1,D2,640
D,Colombia,3,4,1,2,-1,D3,640
D,Paraguay,3,3,2,6,-4,D4,640
A,Argentina,3,9,6,1,5,A1,641
A,Chile,3,4,2,3,-1,A2,641
A,Canada,3,2,1,2,-1,A3,641
A,Peru,3,1,1,4,-3,A4,641
B,Ecuador,3,7,3,0,3,B1,641
B,Venezuela,3,6,4,2,2,B2,641
B,Mexico,3,4,2,3,-1,B3,641
B,Jamaica,3,0,0,4,-4,B4,641
C,Uruguay,3,7,6,4,2,C1,641
C,United States,3,6,8,5,3,C2,641
C,Panama,3,4,3,5,-2,C3,641
C,Bolivia,3,0,4,7,-3,C4,641
D,Brazil,3,6,7,2,5,D1,641
D,Costa Rica,3,6,5,5,0,D2,641
D,Colombia,3,3,3,4,-1,D3,641
D,Paraguay,3,3,3,7,-4,D4,641
A,Argentina,3,7,7,3,4,A1,642
A,Peru,3,5,5,2,3,A2,642
A,Chile,3,4,2,2,0,A3,642
A,Canada,3,0,0,7,-7,A4,642
B,Mexico,3,7,4,2,2,B1,642
B,Venezuela,3,6,6,4,2,B2,642
B,Ecuador,3,4,6,4,2,B3,642
B,Jamaica,3,0,0,6,-6,B4,642
C,United States,3,6,4,2,2,C1,642
C,Uruguay,3,5,3,2,1,C2,642
C,Bolivia,3,4,4,4,0,C3,642
C,Panama,3,1,1,4,-3,C4,642
D,Brazil,3,7,5,1,4,D1,642
D,Colombia,3,4,2,2,0,D2,642
D,Costa Rica,3,4,3,5,-2,D3,642
D,Paraguay,3,1,2,4,-2,D4,642
A,Argentina,3,9,7,3,4,A1,643
A,Peru,3,4,5,5,0,A2,643
A,Chile,3,3,7,5,2,A3,643
A,Canada,3,1,2,8,-6,A4,643
B,Venezuela,3,7,7,1,6,B1,643
B,Mexico,3,4,4,5,-1,B2,643
B,Ecuador,3,4,4,7,-3,B3,643
B,Jamaica,3,1,1,3,-2,B4,643
C,United States,3,7,9,2,7,C1,643
C,Uruguay,3,7,6,3,3,C2,643
C,Panama,3,1,2,6,-4,C3,643
C,Bolivia,3,1,1,7,-6,C4,643
D,Brazil,3,7,8,1,7,D1,643
D,Colombia,3,7,4,0,4,D2,643
D,Costa Rica,3,3,2,6,-4,D3,643
D,Paraguay,3,0,0,7,-7,D4,643
A,Chile,3,7,6,3,3,A1,644
A,Peru,3,4,5,5,0,A2,644
A,Argentina,3,3,4,4,0,A3,644
A,Canada,3,1,2,5,-3,A4,644
B,Jamaica,3,7,4,0,4,B1,644
B,Venezuela,3,7,3,0,3,B2,644
B,Mexico,3,1,3,6,-3,B3,644
B,Ecuador,3,1,3,7,-4,B4,644
C,Panama,3,9,4,1,3,C1,644
C,Uruguay,3,4,6,4,2,C2,644
C,United States,3,2,3,4,-1,C3,644
C,Bolivia,3,1,1,5,-4,C4,644
D,Brazil,3,9,5,0,5,D1,644
D,Colombia,3,4,3,3,0,D2,644
D,Paraguay,3,3,1,3,-2,D3,644
D,Costa Rica,3,1,1,4,-3,D4,644
A,Argentina,3,9,5,0,5,A1,645
A,Canada,3,3,4,5,-1,A2,645
A,Peru,3,3,4,6,-2,A3,645
A,Chile,3,3,3,5,-2,A4,645
B,Jamaica,3,7,7,3,4,B1,645
B,Mexico,3,7,4,2,2,B2,645
B,Venezuela,3,3,4,5,-1,B3,645
B,Ecuador,3,0,2,7,-5,B4,645
C,Uruguay,3,9,11,2,9,C1,645
C,United States,3,4,5,4,1,C2,645
C,Panama,3,3,6,8,-2,C3,645
C,Bolivia,3,1,1,9,-8,C4,645
D,Brazil,3,9,10,0,10,D1,645
D,Paraguay,3,4,1,2,-1,D2,645
D,Costa Rica,3,3,1,4,-3,D3,645
D,Colombia,3,1,0,6,-6,D4,645
A,Argentina,3,7,8,3,5,A1,646
A,Chile,3,5,3,2,1,A2,646
A,Peru,3,3,3,4,-1,A3,646
A,Canada,3,1,2,7,-5,A4,646
B,Ecuador,3,9,12,7,5,B1,646
B,Mexico,3,3,5,5,0,B2,646
B,Venezuela,3,3,4,6,-2,B3,646
B,Jamaica,3,3,4,7,-3,B4,646
C,United States,3,9,7,2,5,C1,646
C,Uruguay,3,6,6,3,3,C2,646
C,Bolivia,3,3,3,8,-5,C3,646
C,Panama,3,0,2,5,-3,C4,646
D,Colombia,3,7,4,2,2,D1,646
D,Brazil,3,4,4,3,1,D2,646
D,Costa Rica,3,2,4,5,-1,D3,646
D,Paraguay,3,2,4,6,-2,D4,646
A,Argentina,3,9,5,0,5,A1,647
A,Canada,3,4,6,4,2,A2,647
A,Chile,3,4,5,4,1,A3,647
A,Peru,3,0,1,9,-8,A4,647
B,Mexico,3,9,7,0,7,B1,647
B,Venezuela,3,6,5,4,1,B2,647
B,Ecuador,3,3,4,7,-3,B3,647
B,Jamaica,3,0,1,6,-5,B4,647
C,United States,3,7,4,2,2,C1,647
C,Uruguay,3,7,4,2,2,C2,647
C,Panama,3,3,2,3,-1,C3,647
C,Bolivia,3,0,1,4,-3,C4,647
D,Paraguay,3,7,4,1,3,D1,647
D,Costa Rica,3,6,2,2,0,D2,647
D,Brazil,3,2,2,3,-1,D3,647
D,Colombia,3,1,1,3,-2,D4,647
A,Argentina,3,9,9,2,7,A1,648
A,Chile,3,6,7,6,1,A2,648
A,Peru,3,3,3,4,-1,A3,648
A,Canada,3,0,4,11,-7,A4,648
B,Ecuador,3,9,7,2,5,B1,648
B,Mexico,3,6,5,4,1,B2,648
B,Venezuela,3,3,4,6,-2,B3,648
B,Jamaica,3,0,2,6,-4,B4,648
C,Uruguay,3,9,6,1,5,C1,648
C,United States,3,6,4,3,1,C2,648
C,Panama,3,3,1,2,-1,C3,648
C,Bolivia,3,0,0,5,-5,C4,648
D,Colombia,3,7,5,2,3,D1,648
D,Brazil,3,6,4,3,1,D2,648
D,Costa Rica,3,4,3,3,0,D3,648
D,Paraguay,3,0,2,6,-4,D4,648
A,Argentina,3,9,10,2,8,A1,649
A,Chile,3,4,5,6,-1,A2,649
A,Peru,3,3,2,5,-3,A3,649
A,Canada,3,1,1,5,-4,A4,649
B,Jamaica,3,7,6,2,4,B1,649
B,Mexico,3,5,5,3,2,B2,649
B,Venezuela,3,4,4,6,-2,B3,649
B,Ecuador,3,0,0,4,-4,B4,649
C,United States,3,7,9,4,5,C1,649
C,Uruguay,3,5,5,3,2,C2,649
C,Bolivia,3,4,6,8,-2,C3,649
C,Panama,3,0,4,9,-5,C4,649
D,Brazil,3,7,7,0,7,D1,649
D,Paraguay,3,7,2,0,2,D2,649
D,Colombia,3,1,0,2,-2,D3,649
D,Costa Rica,3,1,0,7,-7,D4,649
A,Chile,3,5,6,4,2,A1,650
A,Argentina,3,5,5,3,2,A2,650
A,Canada,3,2,3,5,-2,A3,650
A,Peru,3,2,2,4,-2,A4,650
B,Venezuela,3,7,4,1,3,B1,650
B,Ecuador,3,6,3,2,1,B2,650
B,Mexico,3,4,4,3,1,B3,650
B,Jamaica,3,0,2,7,-5,B4,650
C,Uruguay,3,6,7,3,4,C1,650
C,Panama,3,6,6,5,1,C2,650
C,United States,3,3,1,3,-2,C3,650
C,Bolivia,3,3,2,5,-3,C4,650
D,Brazil,3,5,4,2,2,D1,650
D,Colombia,3,4,4,3,1,D2,650
D,Paraguay,3,4,3,4,-1,D3,650
D,Costa Rica,3,3,4,6,-2,D4,650
A,Argentina,3,6,7,1,6,A1,651
A,Chile,3,4,2,2,0,A2,651
A,Canada,3,4,1,3,-2,A3,651
A,Peru,3,2,1,5,-4,A4,651
B,Ecuador,3,7,4,1,3,B1,651
B,Mexico,3,4,4,3,1,B2,651
B,Venezuela,3,3,2,2,0,B3,651
B,Jamaica,3,1,1,5,-4,B4,651
C,United States,3,9,12,2,10,C1,651
C,Uruguay,3,4,6,5,1,C2,651
C,Bolivia,3,3,3,9,-6,C3,651
C,Panama,3,1,3,8,-5,C4,651
D,Brazil,3,9,8,2,6,D1,651
D,Paraguay,3,3,5,4,1,D2,651
D,Costa Rica,3,3,6,8,-2,D3,651
D,Colombia,3,3,2,7,-5,D4,651
A,Argentina,3,9,5,1,4,A1,652
A,Peru,3,4,3,3,0,A2,652
A,Chile,3,2,2,4,-2,A3,652
A,Canada,3,1,1,3,-2,A4,652
B,Ecuador,3,7,7,4,3,B1,652
B,Jamaica,3,4,2,2,0,B2,652
B,Venezuela,3,3,4,4,0,B3,652
B,Mexico,3,3,2,5,-3,B4,652
C,Uruguay,3,9,7,0,7,C1,652
C,United States,3,6,5,1,4,C2,652
C,Bolivia,3,3,2,7,-5,C3,652
C,Panama,3,0,1,7,-6,C4,652
D,Colombia,3,7,4,2,2,D1,652
D,Brazil,3,6,8,3,5,D2,652
D,Costa Rica,3,3,3,6,-3,D3,652
D,Paraguay,3,1,2,6,-4,D4,652
A,Peru,3,6,8,2,6,A1,653
A,Argentina,3,6,5,3,2,A2,653
A,Chile,3,6,4,3,1,A3,653
A,Canada,3,0,0,9,-9,A4,653
B,Ecuador,3,7,8,3,5,B1,653
B,Jamaica,3,4,5,5,0,B2,653
B,Mexico,3,4,2,3,-1,B3,653
B,Venezuela,3,1,4,8,-4,B4,653
C,United States,3,7,5,2,3,C1,653
C,Bolivia,3,5,7,6,1,C2,653
C,Uruguay,3,4,4,5,-1,C3,653
C,Panama,3,0,3,6,-3,C4,653
D,Brazil,3,9,6,3,3,D1,653
D,Colombia,3,4,3,2,1,D2,653
D,Paraguay,3,3,3,5,-2,D3,653
D,Costa Rica,3,1,4,6,-2,D4,653
A,Argentina,3,9,9,5,4,A1,654
A,Chile,3,4,6,6,0,A2,654
A,Canada,3,2,7,8,-1,A3,654
A,Peru,3,1,5,8,-3,A4,654
B,Jamaica,3,5,2,1,1,B1,654
B,Ecuador,3,3,2,2,0,B2,654
B,Venezuela,3,3,2,2,0,B3,654
B,Mexico,3,2,1,2,-1,B4,654
C,Panama,3,6,5,3,2,C1,654
C,Uruguay,3,6,5,4,1,C2,654
C,United States,3,4,3,3,0,C3,654
C,Bolivia,3,1,1,4,-3,C4,654
D,Brazil,3,6,5,2,3,D1,654
D,Colombia,3,6,3,2,1,D2,654
D,Paraguay,3,4,4,5,-1,D3,654
D,Costa Rica,3,1,3,6,-3,D4,654
A,Argentina,3,9,7,3,4,A1,655
A,Canada,3,4,4,4,0,A2,655
A,Chile,3,2,4,6,-2,A3,655
A,Peru,3,1,0,2,-2,A4,655
B,Ecuador,3,6,7,2,5,B1,655
B,Mexico,3,6,4,2,2,B2,655
B,Venezuela,3,4,3,6,-3,B3,655
B,Jamaica,3,1,0,4,-4,B4,655
C,Uruguay,3,9,10,3,7,C1,655
C,United States,3,6,14,4,10,C2,655
C,Bolivia,3,3,3,14,-11,C3,655
C,Panama,3,0,1,7,-6,C4,655
D,Brazil,3,9,9,1,8,D1,655
D,Colombia,3,6,7,5,2,D2,655
D,Paraguay,3,3,2,7,-5,D3,655
D,Costa Rica,3,0,1,6,-5,D4,655
A,Argentina,3,6,5,3,2,A1,656
A,Canada,3,6,5,5,0,A2,656
A,Chile,3,3,7,5,2,A3,656
A,Peru,3,3,3,7,-4,A4,656
B,Venezuela,3,7,6,3,3,B1,656
B,Jamaica,3,5,5,4,1,B2,656
B,Mexico,3,4,4,4,0,B3,656
B,Ecuador,3,0,1,5,-4,B4,656
C,United States,3,6,4,1,3,C1,656
C,Uruguay,3,6,4,2,2,C2,656
C,Bolivia,3,3,2,3,-1,C3,656
C,Panama,3,3,1,5,-4,C4,656
D,Colombia,3,6,6,4,2,D1,656
D,Brazil,3,6,5,3,2,D2,656
D,Costa Rica,3,3,5,6,-1,D3,656
D,Paraguay,3,3,3,6,-3,D4,656
A,Argentina,3,5,4,1,3,A1,657
A,Canada,3,4,1,3,-2,A2,657
A,Peru,3,3,2,2,0,A3,657
A,Chile,3,2,1,2,-1,A4,657
B,Ecuador,3,6,5,2,3,B1,657
B,Venezuela,3,6,2,3,-1,B2,657
B,Mexico,3,4,3,2,1,B3,657
B,Jamaica,3,1,1,4,-3,B4,657
C,Uruguay,3,5,10,5,5,C1,657
C,United States,3,5,5,4,1,C2,657
C,Panama,3,4,3,3,0,C3,657
C,Bolivia,3,1,1,7,-6,C4,657
D,Paraguay,3,7,3,0,3,D1,657
D,Brazil,3,5,2,1,1,D2,657
D,Colombia,3,4,2,1,1,D3,657
D,Costa Rica,3,0,1,6,-5,D4,657
A,Argentina,3,7,9,3,6,A1,658
A,Peru,3,4,8,7,1,A2,658
A,Chile,3,3,5,6,-1,A3,658
A,Canada,3,3,2,8,-6,A4,658
B,Mexico,3,7,6,2,4,B1,658
B,Venezuela,3,5,5,2,3,B2,658
B,Ecuador,3,4,4,5,-1,B3,658
B,Jamaica,3,0,2,8,-6,B4,658
C,Uruguay,3,5,5,1,4,C1,658
C,Panama,3,5,3,2,1,C2,658
C,United States,3,4,4,2,2,C3,658
C,Bolivia,3,1,0,7,-7,C4,658
D,Colombia,3,9,5,0,5,D1,658
D,Brazil,3,4,5,3,2,D2,658
D,Costa Rica,3,2,3,5,-2,D3,658
D,Paraguay,3,1,1,6,-5,D4,658
A,Argentina,3,7,5,1,4,A1,659
A,Canada,3,4,3,3,0,A2,659
A,Chile,3,3,0,0,0,A3,659
A,Peru,3,1,0,4,-4,A4,659
B,Ecuador,3,7,7,3,4,B1,659
B,Mexico,3,7,5,1,4,B2,659
B,Venezuela,3,3,7,6,1,B3,659
B,Jamaica,3,0,0,9,-9,B4,659
C,Bolivia,3,5,4,2,2,C1,659
C,United States,3,5,3,2,1,C2,659
C,Panama,3,4,2,3,-1,C3,659
C,Uruguay,3,1,1,3,-2,C4,659
D,Brazil,3,9,7,1,6,D1,659
D,Colombia,3,3,3,4,-1,D2,659
D,Costa Rica,3,3,3,5,-2,D3,659
D,Paraguay,3,3,2,5,-3,D4,659
A,Argentina,3,7,3,0,3,A1,660
A,Peru,3,6,4,1,3,A2,660
A,Canada,3,3,2,5,-3,A3,660
A,Chile,3,1,1,4,-3,A4,660
B,Mexico,3,7,6,1,5,B1,660
B,Ecuador,3,4,3,2,1,B2,660
B,Jamaica,3,4,2,5,-3,B3,660
B,Venezuela,3,1,1,4,-3,B4,660
C,United States,3,9,8,1,7,C1,660
C,Panama,3,4,3,4,-1,C2,660
C,Uruguay,3,3,1,3,-2,C3,660
C,Bolivia,3,1,3,7,-4,C4,660
D,Brazil,3,9,6,0,6,D1,660
D,Costa Rica,3,6,4,4,0,D2,660
D,Colombia,3,1,1,4,-3,D3,660
D,Paraguay,3,1,1,4,-3,D4,660
A,Argentina,3,7,6,2,4,A1,661
A,Chile,3,4,3,3,0,A2,661
A,Canada,3,3,3,5,-2,A3,661
A,Peru,3,2,1,3,-2,A4,661
B,Ecuador,3,7,4,1,3,B1,661
B,Venezuela,3,4,2,3,-1,B2,661
B,Jamaica,3,3,4,5,-1,B3,661
B,Mexico,3,3,4,5,-1,B4,661
C,Uruguay,3,7,8,5,3,C1,661
C,United States,3,5,7,4,3,C2,661
C,Bolivia,3,4,4,5,-1,C3,661
C,Panama,3,0,2,7,-5,C4,661
D,Colombia,3,7,4,2,2,D1,661
D,Brazil,3,6,3,1,2,D2,661
D,Paraguay,3,2,2,3,-1,D3,661
D,Costa Rica,3,1,0,3,-3,D4,661
A,Argentina,3,5,6,2,4,A1,662
A,Chile,3,4,2,1,1,A2,662
A,Canada,3,4,3,6,-3,A3,662
A,Peru,3,2,2,4,-2,A4,662
B,Ecuador,3,7,4,1,3,B1,662
B,Jamaica,3,3,1,1,0,B2,662
B,Mexico,3,2,4,5,-1,B3,662
B,Venezuela,3,2,2,4,-2,B4,662
C,Uruguay,3,7,5,3,2,C1,662
C,United States,3,6,6,3,3,C2,662
C,Bolivia,3,4,5,4,1,C3,662
C,Panama,3,0,0,6,-6,C4,662
D,Brazil,3,7,3,1,2,D1,662
D,Paraguay,3,6,6,3,3,D2,662
D,Costa Rica,3,3,2,4,-2,D3,662
D,Colombia,3,1,0,3,-3,D4,662
A,Peru,3,7,6,2,4,A1,663
A,Argentina,3,4,4,2,2,A2,663
A,Canada,3,4,3,5,-2,A3,663
A,Chile,3,1,1,5,-4,A4,663
B,Ecuador,3,9,7,0,7,B1,663
B,Mexico,3,4,8,3,5,B2,663
B,Jamaica,3,2,1,4,-3,B3,663
B,Venezuela,3,1,1,10,-9,B4,663
C,United States,3,9,4,0,4,C1,663
C,Uruguay,3,6,2,1,1,C2,663
C,Panama,3,1,1,3,-2,C3,663
C,Bolivia,3,1,1,4,-3,C4,663
D,Brazil,3,9,7,1,6,D1,663
D,Colombia,3,4,3,2,1,D2,663
D,Paraguay,3,4,4,4,0,D3,663
D,Costa Rica,3,0,0,7,-7,D4,663
A,Peru,3,9,9,2,7,A1,664
A,Argentina,3,6,5,4,1,A2,664
A,Canada,3,3,4,8,-4,A3,664
A,Chile,3,0,2,6,-4,A4,664
B,Mexico,3,6,6,3,3,B1,664
B,Ecuador,3,6,4,3,1,B2,664
B,Jamaica,3,3,3,4,-1,B3,664
B,Venezuela,3,3,5,8,-3,B4,664
C,United States,3,6,8,3,5,C1,664
C,Uruguay,3,6,6,5,1,C2,664
C,Bolivia,3,4,5,6,-1,C3,664
C,Panama,3,1,4,9,-5,C4,664
D,Colombia,3,9,5,0,5,D1,664
D,Brazil,3,4,4,2,2,D2,664
D,Paraguay,3,4,1,1,0,D3,664
D,Costa Rica,3,0,1,8,-7,D4,664
A,Argentina,3,6,8,2,6,A1,665
A,Peru,3,6,6,2,4,A2,665
A,Chile,3,3,2,5,-3,A3,665
A,Canada,3,3,3,10,-7,A4,665
B,Ecuador,3,7,5,0,5,B1,665
B,Mexico,3,5,4,2,2,B2,665
B,Venezuela,3,2,3,6,-3,B3,665
B,Jamaica,3,1,1,5,-4,B4,665
C,United States,3,6,7,4,3,C1,665
C,Uruguay,3,6,5,3,2,C2,665
C,Panama,3,6,5,4,1,C3,665
C,Bolivia,3,0,4,10,-6,C4,665
D,Colombia,3,7,4,1,3,D1,665
D,Paraguay,3,6,3,2,1,D2,665
D,Brazil,3,4,5,2,3,D3,665
D,Costa Rica,3,0,1,8,-7,D4,665
A,Chile,3,9,5,1,4,A1,666
A,Argentina,3,6,9,3,6,A2,666
A,Canada,3,3,3,7,-4,A3,666
A,Peru,3,0,3,9,-6,A4,666
B,Mexico,3,7,6,2,4,B1,666
B,Ecuador,3,7,5,1,4,B2,666
B,Jamaica,3,3,2,5,-3,B3,666
B,Venezuela,3,0,1,6,-5,B4,666
C,Uruguay,3,9,10,2,8,C1,666
C,United States,3,4,3,3,0,C2,666
C,Bolivia,3,4,1,5,-4,C3,666
C,Panama,3,0,2,6,-4,C4,666
D,Brazil,3,9,7,1,6,D1,666
D,Colombia,3,4,3,1,2,D2,666
D,Paraguay,3,4,4,4,0,D3,666
D,Costa Rica,3,0,1,9,-8,D4,666
A,Argentina,3,7,8,5,3,A1,667
A,Chile,3,5,6,4,2,A2,667
A,Canada,3,3,4,7,-3,A3,667
A,Peru,3,1,2,4,-2,A4,667
B,Ecuador,3,7,7,3,4,B1,667
B,Mexico,3,4,3,2,1,B2,667
B,Venezuela,3,4,3,3,0,B3,667
B,Jamaica,3,1,3,8,-5,B4,667
C,United States,3,9,8,3,5,C1,667
C,Panama,3,6,10,9,1,C2,667
C,Bolivia,3,1,3,5,-2,C3,667
C,Uruguay,3,1,3,7,-4,C4,667
D,Colombia,3,6,3,2,1,D1,667
D,Costa Rica,3,4,2,2,0,D2,667
D,Paraguay,3,4,1,1,0,D3,667
D,Brazil,3,3,1,2,-1,D4,667
A,Argentina,3,5,8,6,2,A1,668
A,Chile,3,4,3,3,0,A2,668
A,Peru,3,4,5,6,-1,A3,668
A,Canada,3,3,4,5,-1,A4,668
B,Mexico,3,7,3,1,2,B1,668
B,Venezuela,3,6,2,1,1,B2,668
B,Ecuador,3,2,1,2,-1,B3,668
B,Jamaica,3,1,0,2,-2,B4,668
C,United States,3,7,8,1,7,C1,668
C,Uruguay,3,5,7,2,5,C2,668
C,Bolivia,3,4,3,6,-3,C3,668
C,Panama,3,0,1,10,-9,C4,668
D,Brazil,3,7,7,3,4,D1,668
D,Colombia,3,4,2,3,-1,D2,668
D,Costa Rica,3,3,5,5,0,D3,668
D,Paraguay,3,1,1,4,-3,D4,668
A,Peru,3,9,11,2,9,A1,669
A,Argentina,3,4,5,3,2,A2,669
A,Chile,3,4,4,6,-2,A3,669
A,Canada,3,0,2,11,-9,A4,669
B,Mexico,3,5,2,1,1,B1,669
B,Venezuela,3,4,3,2,1,B2,669
B,Ecuador,3,4,3,3,0,B3,669
B,Jamaica,3,2,2,4,-2,B4,669
C,United States,3,9,10,2,8,C1,669
C,Uruguay,3,2,2,3,-1,C2,669
C,Panama,3,2,1,4,-3,C3,669
C,Bolivia,3,2,1,5,-4,C4,669
D,Costa Rica,3,7,3,1,2,D1,669
D,Brazil,3,6,6,2,4,D2,669
D,Paraguay,3,2,2,5,-3,D3,669
D,Colombia,3,1,2,5,-3,D4,669
A,Argentina,3,6,7,1,6,A1,670
A,Peru,3,6,4,3,1,A2,670
A,Chile,3,6,4,4,0,A3,670
A,Canada,3,0,2,9,-7,A4,670
B,Mexico,3,5,7,3,4,B1,670
B,Jamaica,3,4,2,2,0,B2,670
B,Venezuela,3,4,2,5,-3,B3,670
B,Ecuador,3,2,5,6,-1,B4,670
C,United States,3,9,7,2,5,C1,670
C,Uruguay,3,6,5,4,1,C2,670
C,Panama,3,1,2,4,-2,C3,670
C,Bolivia,3,1,1,5,-4,C4,670
D,Brazil,3,7,6,2,4,D1,670
D,Colombia,3,6,5,4,1,D2,670
D,Paraguay,3,3,2,5,-3,D3,670
D,Costa Rica,3,1,2,4,-2,D4,670
A,Argentina,3,9,6,1,5,A1,671
A,Peru,3,4,3,4,-1,A2,671
A,Canada,3,3,4,5,-1,A3,671
A,Chile,3,1,3,6,-3,A4,671
B,Venezuela,3,6,4,1,3,B1,671
B,Jamaica,3,6,2,2,0,B2,671
B,Mexico,3,3,2,3,-1,B3,671
B,Ecuador,3,3,2,4,-2,B4,671
C,United States,3,7,12,3,9,C1,671
C,Uruguay,3,7,7,4,3,C2,671
C,Panama,3,3,5,8,-3,C3,671
C,Bolivia,3,0,1,10,-9,C4,671
D,Brazil,3,7,5,2,3,D1,671
D,Paraguay,3,4,3,1,2,D2,671
D,Colombia,3,4,2,3,-1,D3,671
D,Costa Rica,3,1,1,5,-4,D4,671
A,Chile,3,5,4,2,2,A1,672
A,Peru,3,4,1,2,-1,A2,672
A,Argentina,3,3,2,2,0,A3,672
A,Canada,3,2,0,1,-1,A4,672
B,Mexico,3,7,5,2,3,B1,672
B,Ecuador,3,4,5,5,0,B2,672
B,Venezuela,3,3,3,5,-2,B3,672
B,Jamaica,3,2,1,2,-1,B4,672
C,United States,3,5,3,2,1,C1,672
C,Panama,3,4,3,2,1,C2,672
C,Uruguay,3,4,2,2,0,C3,672
C,Bolivia,3,3,3,5,-2,C4,672
D,Brazil,3,5,7,5,2,D1,672
D,Paraguay,3,5,3,2,1,D2,672
D,Costa Rica,3,4,4,5,-1,D3,672
D,Colombia,3,1,2,4,-2,D4,672
A,Argentina,3,7,8,2,6,A1,673
A,Peru,3,4,2,2,0,A2,673
A,Canada,3,3,4,7,-3,A3,673
A,Chile,3,3,3,6,-3,A4,673
B,Ecuador,3,5,3,1,2,B1,673
B,Mexico,3,4,3,3,0,B2,673
B,Jamaica,3,4,2,2,0,B3,673
B,Venezuela,3,3,1,3,-2,B4,673
C,Uruguay,3,9,7,2,5,C1,673
C,United States,3,6,6,2,4,C2,673
C,Panama,3,3,4,6,-2,C3,673
C,Bolivia,3,0,1,8,-7,C4,673
D,Brazil,3,7,6,1,5,D1,673
D,Costa Rica,3,4,2,4,-2,D2,673
D,Colombia,3,2,3,4,-1,D3,673
D,Paraguay,3,2,1,3,-2,D4,673
A,Chile,3,7,3,1,2,A1,674
A,Argentina,3,4,6,2,4,A2,674
A,Peru,3,2,2,3,-1,A3,674
A,Canada,3,2,2,7,-5,A4,674
B,Ecuador,3,6,5,3,2,B1,674
B,Jamaica,3,6,6,5,1,B2,674
B,Venezuela,3,6,4,3,1,B3,674
B,Mexico,3,0,1,5,-4,B4,674
C,United States,3,7,11,3,8,C1,674
C,Uruguay,3,7,4,1,3,C2,674
C,Bolivia,3,3,3,7,-4,C3,674
C,Panama,3,0,2,9,-7,C4,674
D,Brazil,3,6,9,3,6,D1,674
D,Colombia,3,4,5,3,2,D2,674
D,Paraguay,3,4,3,5,-2,D3,674
D,Costa Rica,3,2,2,8,-6,D4,674
A,Argentina,3,7,4,0,4,A1,675
A,Chile,3,4,5,5,0,A2,675
A,Canada,3,3,3,3,0,A3,675
A,Peru,3,1,1,5,-4,A4,675
B,Ecuador,3,6,6,4,2,B1,675
B,Mexico,3,4,4,3,1,B2,675
B,Venezuela,3,4,4,5,-1,B3,675
B,Jamaica,3,3,4,6,-2,B4,675
C,United States,3,7,5,2,3,C1,675
C,Uruguay,3,6,4,3,1,C2,675
C,Panama,3,3,4,6,-2,C3,675
C,Bolivia,3,1,4,6,-2,C4,675
D,Brazil,3,7,8,0,8,D1,675
D,Paraguay,3,7,5,1,4,D2,675
D,Colombia,3,1,2,6,-4,D3,675
D,Costa Rica,3,1,1,9,-8,D4,675
A,Argentina,3,9,8,1,7,A1,676
A,Canada,3,4,4,2,2,A2,676
A,Peru,3,4,3,3,0,A3,676
A,Chile,3,0,0,9,-9,A4,676
B,Ecuador,3,6,6,1,5,B1,676
B,Mexico,3,5,3,2,1,B2,676
B,Venezuela,3,4,2,3,-1,B3,676
B,Jamaica,3,1,1,6,-5,B4,676
C,United States,3,7,4,1,3,C1,676
C,Uruguay,3,4,4,3,1,C2,676
C,Bolivia,3,3,3,6,-3,C3,676
C,Panama,3,2,1,2,-1,C4,676
D,Colombia,3,7,4,1,3,D1,676
D,Brazil,3,6,6,3,3,D2,676
D,Paraguay,3,4,3,2,1,D3,676
D,Costa Rica,3,0,0,7,-7,D4,676
A,Argentina,3,9,9,3,6,A1,677
A,Peru,3,6,5,5,0,A2,677
A,Canada,3,3,5,6,-1,A3,677
A,Chile,3,0,1,6,-5,A4,677
B,Mexico,3,9,4,1,3,B1,677
B,Jamaica,3,4,2,2,0,B2,677
B,Ecuador,3,4,1,1,0,B3,677
B,Venezuela,3,0,0,3,-3,B4,677
C,Uruguay,3,5,2,0,2,C1,677
C,United States,3,4,2,2,0,C2,677
C,Panama,3,3,3,3,0,C3,677
C,Bolivia,3,2,3,5,-2,C4,677
D,Brazil,3,7,8,2,6,D1,677
D,Paraguay,3,4,1,3,-2,D2,677
D,Colombia,3,2,2,3,-1,D3,677
D,Costa Rica,3,2,2,5,-3,D4,677
A,Argentina,3,9,12,4,8,A1,678
A,Chile,3,4,4,4,0,A2,678
A,Canada,3,4,4,5,-1,A3,678
A,Peru,3,0,2,9,-7,A4,678
B,Mexico,3,7,9,3,6,B1,678
B,Ecuador,3,6,8,3,5,B2,678
B,Jamaica,3,4,1,4,-3,B3,678
B,Venezuela,3,0,1,9,-8,B4,678
C,United States,3,7,6,2,4,C1,678
C,Panama,3,5,3,2,1,C2,678
C,Uruguay,3,4,2,2,0,C3,678
C,Bolivia,3,0,1,6,-5,C4,678
D,Brazil,3,6,6,2,4,D1,678
D,Colombia,3,5,4,3,1,D2,678
D,Paraguay,3,4,6,6,0,D3,678
D,Costa Rica,3,1,3,8,-5,D4,678
A,Chile,3,7,3,1,2,A1,679
A,Argentina,3,6,3,1,2,A2,679
A,Canada,3,3,1,3,-2,A3,679
A,Peru,3,1,1,3,-2,A4,679
B,Ecuador,3,7,5,1,4,B1,679
B,Venezuela,3,6,7,1,6,B2,679
B,Mexico,3,4,3,6,-3,B3,679
B,Jamaica,3,0,0,7,-7,B4,679
C,Uruguay,3,7,5,1,4,C1,679
C,United States,3,5,5,1,4,C2,679
C,Bolivia,3,3,1,5,-4,C3,679
C,Panama,3,1,0,4,-4,C4,679
D,Brazil,3,9,5,2,3,D1,679
D,Paraguay,3,4,2,2,0,D2,679
D,Colombia,3,3,2,2,0,D3,679
D,Costa Rica,3,1,1,4,-3,D4,679
A,Argentina,3,5,9,4,5,A1,680
A,Canada,3,3,4,4,0,A2,680
A,Chile,3,3,4,4,0,A3,680
A,Peru,3,2,2,7,-5,A4,680
B,Ecuador,3,7,6,3,3,B1,680
B,Mexico,3,6,7,2,5,B2,680
B,Venezuela,3,2,2,6,-4,B3,680
B,Jamaica,3,1,2,6,-4,B4,680
C,Uruguay,3,6,4,2,2,C1,680
C,United States,3,5,4,2,2,C2,680
C,Bolivia,3,4,3,4,-1,C3,680
C,Panama,3,1,2,5,-3,C4,680
D,Colombia,3,5,5,2,3,D1,680
D,Brazil,3,4,3,1,2,D2,680
D,Costa Rica,3,4,3,4,-1,D3,680
D,Paraguay,3,3,2,6,-4,D4,680
A,Argentina,3,9,4,0,4,A1,681
A,Chile,3,6,4,2,2,A2,681
A,Canada,3,1,3,6,-3,A3,681
A,Peru,3,1,2,5,-3,A4,681
B,Ecuador,3,7,5,2,3,B1,681
B,Venezuela,3,5,3,2,1,B2,681
B,Mexico,3,2,2,4,-2,B3,681
B,Jamaica,3,1,0,2,-2,B4,681
C,United States,3,7,3,0,3,C1,681
C,Uruguay,3,6,8,5,3,C2,681
C,Bolivia,3,2,2,3,-1,C3,681
C,Panama,3,1,2,7,-5,C4,681
D,Brazil,3,9,8,2,6,D1,681
D,Paraguay,3,6,6,6,0,D2,681
D,Colombia,3,1,2,4,-2,D3,681
D,Costa Rica,3,1,5,9,-4,D4,681
A,Canada,3,7,5,2,3,A1,682
A,Argentina,3,6,7,2,5,A2,682
A,Chile,3,4,4,5,-1,A3,682
A,Peru,3,0,1,8,-7,A4,682
B,Mexico,3,7,4,0,4,B1,682
B,Ecuador,3,6,3,3,0,B2,682
B,Venezuela,3,3,2,4,-2,B3,682
B,Jamaica,3,1,2,4,-2,B4,682
C,Uruguay,3,7,7,5,2,C1,682
C,United States,3,5,5,4,1,C2,682
C,Bolivia,3,2,4,5,-1,C3,682
C,Panama,3,1,1,3,-2,C4,682
D,Brazil,3,9,4,1,3,D1,682
D,Colombia,3,4,4,3,1,D2,682
D,Paraguay,3,2,2,3,-1,D3,682
D,Costa Rica,3,1,1,4,-3,D4,682
A,Argentina,3,7,5,1,4,A1,683
A,Peru,3,4,4,5,-1,A2,683
A,Chile,3,3,4,4,0,A3,683
A,Canada,3,1,2,5,-3,A4,683
B,Mexico,3,9,6,1,5,B1,683
B,Ecuador,3,6,5,3,2,B2,683
B,Venezuela,3,1,2,4,-2,B3,683
B,Jamaica,3,1,2,7,-5,B4,683
C,Uruguay,3,9,5,1,4,C1,683
C,United States,3,6,3,1,2,C2,683
C,Panama,3,3,2,2,0,C3,683
C,Bolivia,3,0,1,7,-6,C4,683
D,Brazil,3,6,4,3,1,D1,683
D,Colombia,3,4,3,2,1,D2,683
D,Paraguay,3,4,1,1,0,D3,683
D,Costa Rica,3,2,0,2,-2,D4,683
A,Argentina,3,7,8,0,8,A1,684
A,Chile,3,6,5,6,-1,A2,684
A,Peru,3,4,2,1,1,A3,684
A,Canada,3,0,2,10,-8,A4,684
B,Mexico,3,7,6,2,4,B1,684
B,Ecuador,3,4,2,2,0,B2,684
B,Venezuela,3,3,1,1,0,B3,684
B,Jamaica,3,1,2,6,-4,B4,684
C,Uruguay,3,4,4,3,1,C1,684
C,United States,3,4,2,2,0,C2,684
C,Bolivia,3,4,3,4,-1,C3,684
C,Panama,3,3,1,1,0,C4,684
D,Colombia,3,7,5,2,3,D1,684
D,Brazil,3,4,4,3,1,D2,684
D,Paraguay,3,4,3,2,1,D3,684
D,Costa Rica,3,1,2,7,-5,D4,684
A,Argentina,3,6,6,4,2,A1,685
A,Canada,3,4,9,7,2,A2,685
A,Chile,3,4,5,6,-1,A3,685
A,Peru,3,3,3,6,-3,A4,685
B,Mexico,3,7,4,2,2,B1,685
B,Venezuela,3,4,3,2,1,B2,685
B,Ecuador,3,2,0,1,-1,B3,685
B,Jamaica,3,2,3,5,-2,B4,685
C,United States,3,9,10,4,6,C1,685
C,Uruguay,3,4,4,5,-1,C2,685
C,Panama,3,2,6,7,-1,C3,685
C,Bolivia,3,1,2,6,-4,C4,685
D,Colombia,3,6,4,2,2,D1,685
D,Brazil,3,4,4,4,0,D2,685
D,Costa Rica,3,4,4,5,-1,D3,685
D,Paraguay,3,2,3,4,-1,D4,685
A,Argentina,3,9,9,1,8,A1,686
A,Chile,3,6,6,6,0,A2,686
A,Peru,3,3,1,6,-5,A3,686
A,Canada,3,0,2,5,-3,A4,686
B,Ecuador,3,9,5,1,4,B1,686
B,Mexico,3,2,2,3,-1,B2,686
B,Venezuela,3,2,1,2,-1,B3,686
B,Jamaica,3,2,2,4,-2,B4,686
C,United States,3,9,9,0,9,C1,686
C,Uruguay,3,6,5,2,3,C2,686
C,Panama,3,3,2,7,-5,C3,686
C,Bolivia,3,0,0,7,-7,C4,686
D,Colombia,3,7,4,2,2,D1,686
D,Brazil,3,6,5,2,3,D2,686
D,Paraguay,3,4,3,2,1,D3,686
D,Costa Rica,3,0,2,8,-6,D4,686
A,Argentina,3,5,5,2,3,A1,687
A,Canada,3,5,2,1,1,A2,687
A,Chile,3,4,3,3,0,A3,687
A,Peru,3,1,1,5,-4,A4,687
B,Venezuela,3,7,5,2,3,B1,687
B,Mexico,3,5,5,3,2,B2,687
B,Ecuador,3,4,3,4,-1,B3,687
B,Jamaica,3,0,1,5,-4,B4,687
C,Uruguay,3,9,8,0,8,C1,687
C,United States,3,6,3,3,0,C2,687
C,Panama,3,3,3,4,-1,C3,687
C,Bolivia,3,0,2,9,-7,C4,687
D,Costa Rica,3,5,4,3,1,D1,687
D,Colombia,3,3,3,3,0,D2,687
D,Paraguay,3,3,3,3,0,D3,687
D,Brazil,3,2,3,4,-1,D4,687
A,Peru,3,5,2,1,1,A1,688
A,Argentina,3,4,2,2,0,A2,688
A,Chile,3,4,3,4,-1,A3,688
A,Canada,3,3,5,5,0,A4,688
B,Ecuador,3,7,5,2,3,B1,688
B,Mexico,3,4,6,6,0,B2,688
B,Venezuela,3,4,5,5,0,B3,688
B,Jamaica,3,1,1,4,-3,B4,688
C,Uruguay,3,7,7,4,3,C1,688
C,United States,3,4,4,4,0,C2,688
C,Bolivia,3,3,4,4,0,C3,688
C,Panama,3,3,4,7,-3,C4,688
D,Brazil,3,7,5,2,3,D1,688
D,Paraguay,3,7,5,3,2,D2,688
D,Colombia,3,3,5,4,1,D3,688
D,Costa Rica,3,0,1,7,-6,D4,688
A,Argentina,3,9,13,2,11,A1,689
A,Peru,3,4,4,5,-1,A2,689
A,Chile,3,4,6,8,-2,A3,689
A,Canada,3,0,2,10,-8,A4,689
B,Ecuador,3,6,5,2,3,B1,689
B,Mexico,3,5,3,1,2,B2,689
B,Jamaica,3,4,3,3,0,B3,689
B,Venezuela,3,1,1,6,-5,B4,689
C,United States,3,7,10,1,9,C1,689
C,Uruguay,3,7,4,1,3,C2,689
C,Bolivia,3,3,3,8,-5,C3,689
C,Panama,3,0,1,8,-7,C4,689
D,Colombia,3,7,9,2,7,D1,689
D,Brazil,3,7,5,1,4,D2,689
D,Paraguay,3,3,3,8,-5,D3,689
D,Costa Rica,3,0,1,7,-6,D4,689
A,Argentina,3,7,6,3,3,A1,690
A,Chile,3,5,2,1,1,A2,690
A,Peru,3,2,4,5,-1,A3,690
A,Canada,3,1,4,7,-3,A4,690
B,Ecuador,3,9,7,0,7,B1,690
B,Mexico,3,6,3,1,2,B2,690
B,Venezuela,3,3,2,3,-1,B3,690
B,Jamaica,3,0,1,9,-8,B4,690
C,United States,3,9,6,1,5,C1,690
C,Uruguay,3,4,2,1,1,C2,690
C,Bolivia,3,3,3,6,-3,C3,690
C,Panama,3,1,3,6,-3,C4,690
D,Brazil,3,6,6,2,4,D1,690
D,Colombia,3,6,4,1,3,D2,690
D,Paraguay,3,6,4,3,1,D3,690
D,Costa Rica,3,0,1,9,-8,D4,690
A,Argentina,3,9,8,1,7,A1,691
A,Chile,3,6,4,4,0,A2,691
A,Peru,3,3,4,6,-2,A3,691
A,Canada,3,0,1,6,-5,A4,691
B,Mexico,3,9,7,1,6,B1,691
B,Venezuela,3,6,4,1,3,B2,691
B,Jamaica,3,3,4,6,-2,B3,691
B,Ecuador,3,0,0,7,-7,B4,691
C,United States,3,9,6,1,5,C1,691
C,Uruguay,3,6,8,5,3,C2,691
C,Bolivia,3,3,2,3,-1,C3,691
C,Panama,3,0,1,8,-7,C4,691
D,Brazil,3,7,3,0,3,D1,691
D,Colombia,3,5,3,0,3,D2,691
D,Costa Rica,3,3,1,5,-4,D3,691
D,Paraguay,3,1,0,2,-2,D4,691
A,Chile,3,6,2,2,0,A1,692
A,Canada,3,4,2,1,1,A2,692
A,Argentina,3,4,4,4,0,A3,692
A,Peru,3,2,2,3,-1,A4,692
B,Mexico,3,7,7,2,5,B1,692
B,Venezuela,3,4,3,2,1,B2,692
B,Ecuador,3,3,5,7,-2,B3,692
B,Jamaica,3,2,0,4,-4,B4,692
C,Uruguay,3,7,9,3,6,C1,692
C,Bolivia,3,4,5,6,-1,C2,692
C,Panama,3,3,2,6,-4,C3,692
C,United States,3,2,3,4,-1,C4,692
D,Brazil,3,9,9,2,7,D1,692
D,Paraguay,3,6,4,6,-2,D2,692
D,Colombia,3,1,2,4,-2,D3,692
D,Costa Rica,3,1,1,4,-3,D4,692
A,Argentina,3,9,9,2,7,A1,693
A,Chile,3,4,3,5,-2,A2,693
A,Canada,3,3,6,9,-3,A3,693
A,Peru,3,1,3,5,-2,A4,693
B,Ecuador,3,7,7,2,5,B1,693
B,Mexico,3,5,6,3,3,B2,693
B,Venezuela,3,4,3,6,-3,B3,693
B,Jamaica,3,0,1,6,-5,B4,693
C,Uruguay,3,7,7,1,6,C1,693
C,United States,3,4,8,3,5,C2,693
C,Bolivia,3,3,2,6,-4,C3,693
C,Panama,3,3,3,10,-7,C4,693
D,Brazil,3,7,5,2,3,D1,693
D,Colombia,3,4,1,2,-1,D2,693
D,Paraguay,3,3,2,3,-1,D3,693
D,Costa Rica,3,2,1,2,-1,D4,693
A,Argentina,3,7,7,3,4,A1,694
A,Peru,3,4,6,5,1,A2,694
A,Chile,3,4,2,4,-2,A3,694
A,Canada,3,1,1,4,-3,A4,694
B,Ecuador,3,7,6,2,4,B1,694
B,Jamaica,3,6,4,4,0,B2,694
B,Mexico,3,2,2,3,-1,B3,694
B,Venezuela,3,1,2,5,-3,B4,694
C,United States,3,7,6,2,4,C1,694
C,Uruguay,3,4,4,3,1,C2,694
C,Panama,3,4,4,5,-1,C3,694
C,Bolivia,3,1,3,7,-4,C4,694
D,Brazil,3,5,2,1,1,D1,694
D,Colombia,3,4,3,3,0,D2,694
D,Paraguay,3,4,1,2,-1,D3,694
D,Costa Rica,3,3,2,2,0,D4,694
A,Peru,3,6,4,3,1,A1,695
A,Canada,3,4,4,3,1,A2,695
A,Argentina,3,4,1,2,-1,A3,695
A,Chile,3,2,0,1,-1,A4,695
B,Venezuela,3,6,8,4,4,B1,695
B,Mexico,3,6,5,3,2,B2,695
B,Ecuador,3,6,5,4,1,B3,695
B,Jamaica,3,0,2,9,-7,B4,695
C,United States,3,7,7,3,4,C1,695
C,Panama,3,4,4,5,-1,C2,695
C,Bolivia,3,2,1,2,-1,C3,695
C,Uruguay,3,2,3,5,-2,C4,695
D,Brazil,3,9,5,1,4,D1,695
D,Colombia,3,6,3,3,0,D2,695
D,Paraguay,3,1,2,4,-2,D3,695
D,Costa Rica,3,1,0,2,-2,D4,695
A,Argentina,3,9,7,2,5,A1,696
A,Canada,3,6,4,3,1,A2,696
A,Peru,3,3,3,5,-2,A3,696
A,Chile,3,0,3,7,-4,A4,696
B,Ecuador,3,7,3,1,2,B1,696
B,Mexico,3,4,3,3,0,B2,696
B,Jamaica,3,3,2,3,-1,B3,696
B,Venezuela,3,2,0,1,-1,B4,696
C,United States,3,7,7,4,3,C1,696
C,Uruguay,3,6,5,4,1,C2,696
C,Panama,3,4,2,2,0,C3,696
C,Bolivia,3,0,2,6,-4,C4,696
D,Brazil,3,9,4,0,4,D1,696
D,Costa Rica,3,4,5,3,2,D2,696
D,Colombia,3,4,3,4,-1,D3,696
D,Paraguay,3,0,0,5,-5,D4,696
A,Argentina,3,7,9,2,7,A1,697
A,Chile,3,4,4,5,-1,A2,697
A,Canada,3,2,2,5,-3,A3,697
A,Peru,3,2,1,4,-3,A4,697
B,Ecuador,3,5,6,3,3,B1,697
B,Mexico,3,5,2,0,2,B2,697
B,Venezuela,3,4,3,5,-2,B3,697
B,Jamaica,3,1,1,4,-3,B4,697
C,United States,3,7,9,3,6,C1,697
C,Panama,3,6,4,4,0,C2,697
C,Uruguay,3,2,1,2,-1,C3,697
C,Bolivia,3,1,1,6,-5,C4,697
D,Colombia,3,7,3,0,3,D1,697
D,Paraguay,3,6,6,3,3,D2,697
D,Costa Rica,3,3,2,5,-3,D3,697
D,Brazil,3,1,2,5,-3,D4,697
A,Argentina,3,9,7,0,7,A1,698
A,Chile,3,4,4,5,-1,A2,698
A,Canada,3,3,3,5,-2,A3,698
A,Peru,3,1,1,5,-4,A4,698
B,Ecuador,3,6,4,2,2,B1,698
B,Mexico,3,6,4,4,0,B2,698
B,Venezuela,3,3,4,3,1,B3,698
B,Jamaica,3,3,2,5,-3,B4,698
C,Uruguay,3,6,7,2,5,C1,698
C,Bolivia,3,4,3,5,-2,C2,698
C,United States,3,4,2,4,-2,C3,698
C,Panama,3,3,3,4,-1,C4,698
D,Brazil,3,6,5,1,4,D1,698
D,Colombia,3,5,2,1,1,D2,698
D,Costa Rica,3,4,4,3,1,D3,698
D,Paraguay,3,1,0,6,-6,D4,698
A,Argentina,3,7,4,0,4,A1,699
A,Canada,3,4,4,5,-1,A2,699
A,Peru,3,2,3,4,-1,A3,699
A,Chile,3,2,3,5,-2,A4,699
B,Jamaica,3,5,5,4,1,B1,699
B,Venezuela,3,4,5,5,0,B2,699
B,Mexico,3,4,4,4,0,B3,699
B,Ecuador,3,3,4,5,-1,B4,699
C,Uruguay,3,7,7,4,3,C1,699
C,United States,3,5,10,3,7,C2,699
C,Panama,3,4,4,3,1,C3,699
C,Bolivia,3,0,3,14,-11,C4,699
D,Brazil,3,9,10,1,9,D1,699
D,Paraguay,3,4,2,5,-3,D2,699
D,Colombia,3,3,3,3,0,D3,699
D,Costa Rica,3,1,2,8,-6,D4,699
A,Argentina,3,5,2,1,1,A1,700
A,Peru,3,4,3,3,0,A2,700
A,Canada,3,4,2,2,0,A3,700
A,Chile,3,3,1,2,-1,A4,700
B,Mexico,3,5,4,3,1,B1,700
B,Venezuela,3,4,3,2,1,B2,700
B,Ecuador,3,3,5,5,0,B3,700
B,Jamaica,3,2,3,5,-2,B4,700
C,United States,3,9,9,0,9,C1,700
C,Uruguay,3,4,2,2,0,C2,700
C,Panama,3,3,2,6,-4,C3,700
C,Bolivia,3,1,1,6,-5,C4,700
D,Brazil,3,9,8,3,5,D1,700
D,Colombia,3,6,6,4,2,D2,700
D,Costa Rica,3,3,3,6,-3,D3,700
D,Paraguay,3,0,1,5,-4,D4,700
A,Argentina,3,7,11,3,8,A1,701
A,Chile,3,7,7,2,5,A2,701
A,Peru,3,1,2,8,-6,A3,701
A,Canada,3,1,1,8,-7,A4,701
B,Ecuador,3,7,5,2,3,B1,701
B,Mexico,3,5,5,4,1,B2,701
B,Venezuela,3,2,4,5,-1,B3,701
B,Jamaica,3,1,4,7,-3,B4,701
C,United States,3,7,4,0,4,C1,701
C,Uruguay,3,6,7,2,5,C2,701
C,Bolivia,3,2,0,3,-3,C3,701
C,Panama,3,1,0,6,-6,C4,701
D,Brazil,3,9,10,2,8,D1,701
D,Colombia,3,6,7,3,4,D2,701
D,Costa Rica,3,3,6,8,-2,D3,701
D,Paraguay,3,0,2,12,-10,D4,701
A,Argentina,3,6,6,3,3,A1,702
A,Chile,3,4,4,4,0,A2,702
A,Peru,3,4,2,4,-2,A3,702
A,Canada,3,2,2,3,-1,A4,702
B,Ecuador,3,9,5,1,4,B1,702
B,Venezuela,3,4,5,5,0,B2,702
B,Mexico,3,4,4,5,-1,B3,702
B,Jamaica,3,0,2,5,-3,B4,702
C,United States,3,9,8,0,8,C1,702
C,Uruguay,3,4,2,3,-1,C2,702
C,Bolivia,3,4,2,6,-4,C3,702
C,Panama,3,0,2,5,-3,C4,702
D,Brazil,3,9,12,1,11,D1,702
D,Colombia,3,6,4,4,0,D2,702
D,Paraguay,3,3,3,7,-4,D3,702
D,Costa Rica,3,0,1,8,-7,D4,702
A,Chile,3,4,6,4,2,A1,703
A,Canada,3,4,4,4,0,A2,703
A,Argentina,3,4,3,3,0,A3,703
A,Peru,3,4,1,3,-2,A4,703
B,Ecuador,3,6,9,4,5,B1,703
B,Venezuela,3,6,3,2,1,B2,703
B,Jamaica,3,3,1,2,-1,B3,703
B,Mexico,3,3,3,8,-5,B4,703
C,Uruguay,3,9,12,4,8,C1,703
C,United States,3,4,4,4,0,C2,703
C,Bolivia,3,2,2,6,-4,C3,703
C,Panama,3,1,4,8,-4,C4,703
D,Costa Rica,3,7,6,3,3,D1,703
D,Brazil,3,4,2,5,-3,D2,703
D,Colombia,3,3,6,5,1,D3,703
D,Paraguay,3,3,4,5,-1,D4,703
A,Argentina,3,7,9,7,2,A1,704
A,Chile,3,4,9,7,2,A2,704
A,Canada,3,3,4,5,-1,A3,704
A,Peru,3,3,4,7,-3,A4,704
B,Mexico,3,7,3,1,2,B1,704
B,Venezuela,3,4,5,3,2,B2,704
B,Ecuador,3,4,3,3,0,B3,704
B,Jamaica,3,1,3,7,-4,B4,704
C,Uruguay,3,9,8,1,7,C1,704
C,United States,3,6,6,3,3,C2,704
C,Bolivia,3,3,2,4,-2,C3,704
C,Panama,3,0,0,8,-8,C4,704
D,Brazil,3,9,8,3,5,D1,704
D,Colombia,3,6,7,5,2,D2,704
D,Paraguay,3,3,4,5,-1,D3,704
D,Costa Rica,3,0,2,8,-6,D4,704
A,Argentina,3,6,6,2,4,A1,705
A,Peru,3,6,5,3,2,A2,705
A,Canada,3,3,3,5,-2,A3,705
A,Chile,3,3,2,6,-4,A4,705
B,Ecuador,3,7,7,3,4,B1,705
B,Mexico,3,7,6,4,2,B2,705
B,Venezuela,3,1,5,8,-3,B3,705
B,Jamaica,3,1,4,7,-3,B4,705
C,Uruguay,3,7,4,1,3,C1,705
C,United States,3,5,2,1,1,C2,705
C,Bolivia,3,3,3,2,1,C3,705
C,Panama,3,1,0,5,-5,C4,705
D,Paraguay,3,7,5,1,4,D1,705
D,Brazil,3,6,6,2,4,D2,705
D,Costa Rica,3,2,2,5,-3,D3,705
D,Colombia,3,1,1,6,-5,D4,705
A,Canada,3,6,6,4,2,A1,706
A,Peru,3,4,8,7,1,A2,706
A,Argentina,3,4,4,5,-1,A3,706
A,Chile,3,3,3,5,-2,A4,706
B,Ecuador,3,7,7,1,6,B1,706
B,Jamaica,3,6,6,8,-2,B2,706
B,Mexico,3,4,6,5,1,B3,706
B,Venezuela,3,0,4,9,-5,B4,706
C,United States,3,9,5,0,5,C1,706
C,Uruguay,3,6,6,4,2,C2,706
C,Bolivia,3,3,3,7,-4,C3,706
C,Panama,3,0,0,3,-3,C4,706
D,Brazil,3,7,3,1,2,D1,706
D,Colombia,3,6,4,3,1,D2,706
D,Paraguay,3,3,1,2,-1,D3,706
D,Costa Rica,3,1,1,3,-2,D4,706
A,Chile,3,7,9,3,6,A1,707
A,Argentina,3,4,4,3,1,A2,707
A,Peru,3,3,2,2,0,A3,707
A,Canada,3,1,1,8,-7,A4,707
B,Mexico,3,9,10,1,9,B1,707
B,Ecuador,3,4,2,5,-3,B2,707
B,Venezuela,3,3,2,2,0,B3,707
B,Jamaica,3,1,0,6,-6,B4,707
C,Uruguay,3,7,10,3,7,C1,707
C,Panama,3,4,3,3,0,C2,707
C,United States,3,4,1,5,-4,C3,707
C,Bolivia,3,1,2,5,-3,C4,707
D,Brazil,3,9,7,1,6,D1,707
D,Costa Rica,3,6,5,4,1,D2,707
D,Colombia,3,1,1,3,-2,D3,707
D,Paraguay,3,1,3,8,-5,D4,707
A,Peru,3,9,4,1,3,A1,708
A,Argentina,3,6,6,5,1,A2,708
A,Chile,3,1,3,5,-2,A3,708
A,Canada,3,1,2,4,-2,A4,708
B,Ecuador,3,7,5,2,3,B1,708
B,Mexico,3,6,5,2,3,B2,708
B,Venezuela,3,2,4,6,-2,B3,708
B,Jamaica,3,1,1,5,-4,B4,708
C,Panama,3,6,4,3,1,C1,708
C,United States,3,6,2,1,1,C2,708
C,Bolivia,3,3,2,3,-1,C3,708
C,Uruguay,3,3,2,3,-1,C4,708
D,Brazil,3,9,8,1,7,D1,708
D,Colombia,3,6,4,2,2,D2,708
D,Paraguay,3,3,1,3,-2,D3,708
D,Costa Rica,3,0,0,7,-7,D4,708
A,Argentina,3,9,9,2,7,A1,709
A,Chile,3,4,5,5,0,A2,709
A,Canada,3,2,1,2,-1,A3,709
A,Peru,3,1,3,9,-6,A4,709
B,Mexico,3,7,6,2,4,B1,709
B,Ecuador,3,5,4,2,2,B2,709
B,Venezuela,3,3,3,5,-2,B3,709
B,Jamaica,3,1,2,6,-4,B4,709
C,Uruguay,3,9,4,0,4,C1,709
C,United States,3,6,6,2,4,C2,709
C,Panama,3,3,4,5,-1,C3,709
C,Bolivia,3,0,0,7,-7,C4,709
D,Paraguay,3,7,4,1,3,D1,709
D,Brazil,3,7,5,3,2,D2,709
D,Colombia,3,3,3,4,-1,D3,709
D,Costa Rica,3,0,1,5,-4,D4,709
A,Chile,3,5,2,1,1,A1,710
A,Argentina,3,4,3,1,2,A2,710
A,Peru,3,4,1,1,0,A3,710
A,Canada,3,2,1,4,-3,A4,710
B,Mexico,3,7,10,0,10,B1,710
B,Venezuela,3,6,3,4,-1,B2,710
B,Ecuador,3,4,2,3,-1,B3,710
B,Jamaica,3,0,1,9,-8,B4,710
C,United States,3,7,7,4,3,C1,710
C,Uruguay,3,6,6,4,2,C2,710
C,Panama,3,4,9,7,2,C3,710
C,Bolivia,3,0,4,11,-7,C4,710
D,Colombia,3,9,8,2,6,D1,710
D,Paraguay,3,4,3,4,-1,D2,710
D,Brazil,3,3,1,2,-1,D3,710
D,Costa Rica,3,1,0,4,-4,D4,710
A,Argentina,3,6,4,3,1,A1,711
A,Peru,3,4,3,3,0,A2,711
A,Chile,3,4,2,2,0,A3,711
A,Canada,3,3,2,3,-1,A4,711
B,Mexico,3,6,7,3,4,B1,711
B,Venezuela,3,6,5,6,-1,B2,711
B,Ecuador,3,4,5,3,2,B3,711
B,Jamaica,3,1,1,6,-5,B4,711
C,Uruguay,3,6,5,1,4,C1,711
C,United States,3,6,6,3,3,C2,711
C,Bolivia,3,6,6,4,2,C3,711
C,Panama,3,0,1,10,-9,C4,711
D,Colombia,3,7,4,1,3,D1,711
D,Brazil,3,6,2,1,1,D2,711
D,Costa Rica,3,2,1,2,-1,D3,711
D,Paraguay,3,1,0,3,-3,D4,711
A,Argentina,3,6,4,3,1,A1,712
A,Peru,3,6,3,4,-1,A2,712
A,Chile,3,3,4,4,0,A3,712
A,Canada,3,3,2,2,0,A4,712
B,Venezuela,3,9,4,1,3,B1,712
B,Ecuador,3,4,5,2,3,B2,712
B,Mexico,3,4,4,2,2,B3,712
B,Jamaica,3,0,1,9,-8,B4,712
C,Bolivia,3,9,8,4,4,C1,712
C,Uruguay,3,6,6,4,2,C2,712
C,Panama,3,3,3,6,-3,C3,712
C,United States,3,0,3,6,-3,C4,712
D,Colombia,3,7,4,1,3,D1,712
D,Brazil,3,6,7,5,2,D2,712
D,Costa Rica,3,3,3,5,-2,D3,712
D,Paraguay,3,1,1,4,-3,D4,712
A,Argentina,3,9,11,3,8,A1,713
A,Chile,3,6,5,6,-1,A2,713
A,Peru,3,3,2,4,-2,A3,713
A,Canada,3,0,1,6,-5,A4,713
B,Ecuador,3,5,6,5,1,B1,713
B,Venezuela,3,4,4,3,1,B2,713
B,Mexico,3,3,4,4,0,B3,713
B,Jamaica,3,2,3,5,-2,B4,713
C,Uruguay,3,9,6,1,5,C1,713
C,United States,3,6,5,2,3,C2,713
C,Panama,3,3,2,4,-2,C3,713
C,Bolivia,3,0,1,7,-6,C4,713
D,Brazil,3,6,4,2,2,D1,713
D,Colombia,3,6,3,2,1,D2,713
D,Paraguay,3,4,1,1,0,D3,713
D,Costa Rica,3,1,0,3,-3,D4,713
A,Chile,3,9,9,1,8,A1,714
A,Peru,3,6,5,3,2,A2,714
A,Argentina,3,3,1,4,-3,A3,714
A,Canada,3,0,0,7,-7,A4,714
B,Ecuador,3,9,7,0,7,B1,714
B,Mexico,3,6,9,3,6,B2,714
B,Venezuela,3,3,1,8,-7,B3,714
B,Jamaica,3,0,1,7,-6,B4,714
C,Uruguay,3,9,7,4,3,C1,714
C,United States,3,4,5,4,1,C2,714
C,Bolivia,3,3,4,6,-2,C3,714
C,Panama,3,1,2,4,-2,C4,714
D,Brazil,3,9,15,1,14,D1,714
D,Colombia,3,4,5,6,-1,D2,714
D,Paraguay,3,2,1,2,-1,D3,714
D,Costa Rica,3,1,1,13,-12,D4,714
A,Argentina,3,5,3,2,1,A1,715
A,Canada,3,4,3,3,0,A2,715
A,Chile,3,4,2,2,0,A3,715
A,Peru,3,3,2,3,-1,A4,715
B,Mexico,3,5,5,4,1,B1,715
B,Ecuador,3,5,4,3,1,B2,715
B,Venezuela,3,4,4,1,3,B3,715
B,Jamaica,3,1,3,8,-5,B4,715
C,Uruguay,3,9,7,1,6,C1,715
C,United States,3,6,10,3,7,C2,715
C,Panama,3,3,1,4,-3,C3,715
C,Bolivia,3,0,1,11,-10,C4,715
D,Colombia,3,9,6,1,5,D1,715
D,Brazil,3,6,5,4,1,D2,715
D,Costa Rica,3,1,1,4,-3,D3,715
D,Paraguay,3,1,1,4,-3,D4,715
A,Argentina,3,7,6,2,4,A1,716
A,Chile,3,5,7,4,3,A2,716
A,Peru,3,2,4,5,-1,A3,716
A,Canada,3,1,4,10,-6,A4,716
B,Ecuador,3,5,2,1,1,B1,716
B,Venezuela,3,5,2,1,1,B2,716
B,Mexico,3,4,3,1,2,B3,716
B,Jamaica,3,1,0,4,-4,B4,716
C,United States,3,5,5,2,3,C1,716
C,Uruguay,3,5,2,0,2,C2,716
C,Bolivia,3,3,2,2,0,C3,716
C,Panama,3,1,2,7,-5,C4,716
D,Colombia,3,9,4,1,3,D1,716
D,Brazil,3,6,9,3,6,D2,716
D,Paraguay,3,3,2,5,-3,D3,716
D,Costa Rica,3,0,2,8,-6,D4,716
A,Argentina,3,9,9,1,8,A1,717
A,Chile,3,6,5,3,2,A2,717
A,Canada,3,3,2,7,-5,A3,717
A,Peru,3,0,1,6,-5,A4,717
B,Mexico,3,6,6,5,1,B1,717
B,Ecuador,3,5,5,3,2,B2,717
B,Venezuela,3,4,4,4,0,B3,717
B,Jamaica,3,1,3,6,-3,B4,717
C,Uruguay,3,6,5,2,3,C1,717
C,Panama,3,4,5,6,-1,C2,717
C,Bolivia,3,4,4,9,-5,C3,717
C,United States,3,3,8,5,3,C4,717
D,Brazil,3,7,9,2,7,D1,717
D,Colombia,3,7,5,3,2,D2,717
D,Costa Rica,3,1,2,5,-3,D3,717
D,Paraguay,3,1,1,7,-6,D4,717
A,Argentina,3,6,9,3,6,A1,718
A,Peru,3,5,6,5,1,A2,718
A,Canada,3,4,2,5,-3,A3,718
A,Chile,3,1,4,8,-4,A4,718
B,Mexico,3,7,5,1,4,B1,718
B,Venezuela,3,6,5,3,2,B2,718
B,Jamaica,3,3,3,4,-1,B3,718
B,Ecuador,3,1,3,8,-5,B4,718
C,United States,3,7,7,1,6,C1,718
C,Uruguay,3,5,5,4,1,C2,718
C,Bolivia,3,2,3,7,-4,C3,718
C,Panama,3,1,2,5,-3,C4,718
D,Colombia,3,9,7,1,6,D1,718
D,Paraguay,3,4,2,5,-3,D2,718
D,Brazil,3,3,4,4,0,D3,718
D,Costa Rica,3,1,2,5,-3,D4,718
A,Chile,3,9,10,3,7,A1,719
A,Argentina,3,6,7,5,2,A2,719
A,Peru,3,3,2,5,-3,A3,719
A,Canada,3,0,3,9,-6,A4,719
B,Mexico,3,7,8,1,7,B1,719
B,Ecuador,3,7,7,2,5,B2,719
B,Venezuela,3,1,1,5,-4,B3,719
B,Jamaica,3,1,2,10,-8,B4,719
C,Uruguay,3,7,7,0,7,C1,719
C,Panama,3,4,3,6,-3,C2,719
C,Bolivia,3,3,1,4,-3,C3,719
C,United States,3,2,2,3,-1,C4,719
D,Brazil,3,5,4,2,2,D1,719
D,Colombia,3,5,4,2,2,D2,719
D,Paraguay,3,3,2,4,-2,D3,719
D,Costa Rica,3,2,2,4,-2,D4,719
A,Argentina,3,6,6,3,3,A1,720
A,Chile,3,4,4,4,0,A2,720
A,Peru,3,4,2,3,-1,A3,720
A,Canada,3,2,2,4,-2,A4,720
B,Jamaica,3,6,4,1,3,B1,720
B,Ecuador,3,5,3,2,1,B2,720
B,Venezuela,3,4,3,4,-1,B3,720
B,Mexico,3,1,2,5,-3,B4,720
C,United States,3,7,7,1,6,C1,720
C,Uruguay,3,7,4,0,4,C2,720
C,Panama,3,3,3,8,-5,C3,720
C,Bolivia,3,0,3,8,-5,C4,720
D,Brazil,3,7,7,2,5,D1,720
D,Paraguay,3,4,3,2,1,D2,720
D,Colombia,3,4,1,2,-1,D3,720
D,Costa Rica,3,1,1,6,-5,D4,720
A,Chile,3,7,9,6,3,A1,721
A,Peru,3,6,8,8,0,A2,721
A,Argentina,3,3,6,6,0,A3,721
A,Canada,3,1,6,9,-3,A4,721
B,Mexico,3,7,4,1,3,B1,721
B,Jamaica,3,7,4,2,2,B2,721
B,Ecuador,3,3,3,3,0,B3,721
B,Venezuela,3,0,0,5,-5,B4,721
C,Uruguay,3,7,8,3,5,C1,721
C,United States,3,4,2,4,-2,C2,721
C,Panama,3,3,2,2,0,C3,721
C,Bolivia,3,1,2,5,-3,C4,721
D,Paraguay,3,5,6,3,3,D1,721
D,Brazil,3,5,4,2,2,D2,721
D,Costa Rica,3,2,3,5,-2,D3,721
D,Colombia,3,2,2,5,-3,D4,721
A,Argentina,3,9,12,3,9,A1,722
A,Chile,3,4,4,7,-3,A2,722
A,Canada,3,3,3,4,-1,A3,722
A,Peru,3,1,4,9,-5,A4,722
B,Jamaica,3,6,5,5,0,B1,722
B,Ecuador,3,4,8,8,0,B2,722
B,Mexico,3,4,4,4,0,B3,722
B,Venezuela,3,3,6,6,0,B4,722
C,Uruguay,3,9,6,2,4,C1,722
C,United States,3,6,4,3,1,C2,722
C,Bolivia,3,3,2,4,-2,C3,722
C,Panama,3,0,4,7,-3,C4,722
D,Brazil,3,7,7,2,5,D1,722
D,Paraguay,3,6,5,4,1,D2,722
D,Colombia,3,4,4,4,0,D3,722
D,Costa Rica,3,0,1,7,-6,D4,722
A,Chile,3,7,3,1,2,A1,723
A,Peru,3,6,5,1,4,A2,723
A,Argentina,3,4,4,4,0,A3,723
A,Canada,3,0,1,7,-6,A4,723
B,Ecuador,3,7,5,1,4,B1,723
B,Mexico,3,6,3,3,0,B2,723
B,Jamaica,3,2,3,4,-1,B3,723
B,Venezuela,3,1,1,4,-3,B4,723
C,Panama,3,9,7,3,4,C1,723
C,Uruguay,3,6,6,3,3,C2,723
C,United States,3,1,1,4,-3,C3,723
C,Bolivia,3,1,2,6,-4,C4,723
D,Brazil,3,7,7,2,5,D1,723
D,Colombia,3,5,5,1,4,D2,723
D,Costa Rica,3,3,2,8,-6,D3,723
D,Paraguay,3,1,2,5,-3,D4,723
A,Canada,3,7,4,1,3,A1,724
A,Peru,3,6,5,4,1,A2,724
A,Chile,3,3,2,4,-2,A3,724
A,Argentina,3,1,2,4,-2,A4,724
B,Ecuador,3,7,6,3,3,B1,724
B,Mexico,3,5,5,3,2,B2,724
B,Venezuela,3,4,4,4,0,B3,724
B,Jamaica,3,0,1,6,-5,B4,724
C,Uruguay,3,7,7,1,6,C1,724
C,United States,3,7,6,1,5,C2,724
C,Bolivia,3,1,3,8,-5,C3,724
C,Panama,3,1,3,9,-6,C4,724
D,Brazil,3,7,6,1,5,D1,724
D,Paraguay,3,4,4,7,-3,D2,724
D,Colombia,3,3,3,3,0,D3,724
D,Costa Rica,3,1,3,5,-2,D4,724
A,Chile,3,7,8,2,6,A1,725
A,Argentina,3,6,3,2,1,A2,725
A,Peru,3,4,4,4,0,A3,725
A,Canada,3,0,1,8,-7,A4,725
B,Ecuador,3,7,3,1,2,B1,725
B,Mexico,3,5,5,3,2,B2,725
B,Jamaica,3,3,3,4,-1,B3,725
B,Venezuela,3,1,3,6,-3,B4,725
C,United States,3,7,4,0,4,C1,725
C,Panama,3,6,6,3,3,C2,725
C,Bolivia,3,2,1,3,-2,C3,725
C,Uruguay,3,1,2,7,-5,C4,725
D,Brazil,3,9,5,0,5,D1,725
D,Colombia,3,2,1,2,-1,D2,725
D,Paraguay,3,2,1,2,-1,D3,725
D,Costa Rica,3,2,2,5,-3,D4,725
A,Argentina,3,9,7,1,6,A1,726
A,Canada,3,2,2,3,-1,A2,726
A,Peru,3,2,0,2,-2,A3,726
A,Chile,3,2,1,4,-3,A4,726
B,Ecuador,3,6,3,2,1,B1,726
B,Venezuela,3,6,3,2,1,B2,726
B,Mexico,3,6,2,1,1,B3,726
B,Jamaica,3,0,2,5,-3,B4,726
C,United States,3,9,5,2,3,C1,726
C,Uruguay,3,4,6,3,3,C2,726
C,Bolivia,3,3,3,5,-2,C3,726
C,Panama,3,1,4,8,-4,C4,726
D,Brazil,3,9,10,1,9,D1,726
D,Colombia,3,4,4,3,1,D2,726
D,Costa Rica,3,3,1,6,-5,D3,726
D,Paraguay,3,1,3,8,-5,D4,726
A,Argentina,3,5,5,3,2,A1,727
A,Peru,3,5,5,3,2,A2,727
A,Canada,3,2,3,5,-2,A3,727
A,Chile,3,2,3,5,-2,A4,727
B,Mexico,3,5,7,3,4,B1,727
B,Venezuela,3,3,4,4,0,B2,727
B,Ecuador,3,3,1,1,0,B3,727
B,Jamaica,3,2,2,6,-4,B4,727
C,Uruguay,3,7,12,2,10,C1,727
C,United States,3,7,9,1,8,C2,727
C,Panama,3,3,4,11,-7,C3,727
C,Bolivia,3,0,2,13,-11,C4,727
D,Brazil,3,9,12,1,11,D1,727
D,Colombia,3,6,2,5,-3,D2,727
D,Paraguay,3,3,2,3,-1,D3,727
D,Costa Rica,3,0,0,7,-7,D4,727
A,Chile,3,9,5,1,4,A1,728
A,Argentina,3,4,3,2,1,A2,728
A,Peru,3,3,4,6,-2,A3,728
A,Canada,3,1,1,4,-3,A4,728
B,Jamaica,3,6,3,2,1,B1,728
B,Mexico,3,5,3,2,1,B2,728
B,Ecuador,3,4,6,3,3,B3,728
B,Venezuela,3,1,1,6,-5,B4,728
C,United States,3,7,10,4,6,C1,728
C,Uruguay,3,4,4,2,2,C2,728
C,Panama,3,3,5,6,-1,C3,728
C,Bolivia,3,3,2,9,-7,C4,728
D,Brazil,3,7,8,2,6,D1,728
D,Colombia,3,7,8,3,5,D2,728
D,Costa Rica,3,3,3,9,-6,D3,728
D,Paraguay,3,0,1,6,-5,D4,728
A,Argentina,3,7,3,0,3,A1,729
A,Peru,3,5,3,1,2,A2,729
A,Chile,3,3,1,4,-3,A3,729
A,Canada,3,1,1,3,-2,A4,729
B,Venezuela,3,7,4,0,4,B1,729
B,Ecuador,3,6,6,4,2,B2,729
B,Mexico,3,4,4,3,1,B3,729
B,Jamaica,3,0,1,8,-7,B4,729
C,Panama,3,6,2,3,-1,C1,729
C,Uruguay,3,5,4,1,3,C2,729
C,United States,3,4,3,1,2,C3,729
C,Bolivia,3,1,1,5,-4,C4,729
D,Paraguay,3,7,4,0,4,D1,729
D,Brazil,3,6,4,1,3,D2,729
D,Colombia,3,4,2,2,0,D3,729
D,Costa Rica,3,0,1,8,-7,D4,729
A,Argentina,3,7,8,0,8,A1,730
A,Peru,3,4,2,2,0,A2,730
A,Chile,3,3,2,6,-4,A3,730
A,Canada,3,3,1,5,-4,A4,730
B,Ecuador,3,9,9,2,7,B1,730
B,Mexico,3,6,6,2,4,B2,730
B,Jamaica,3,3,4,9,-5,B3,730
B,Venezuela,3,0,1,7,-6,B4,730
C,Bolivia,3,6,3,2,1,C1,730
C,Panama,3,5,3,2,1,C2,730
C,United States,3,2,3,4,-1,C3,730
C,Uruguay,3,2,2,3,-1,C4,730
D,Brazil,3,7,6,2,4,D1,730
D,Colombia,3,6,4,3,1,D2,730
D,Costa Rica,3,3,1,3,-2,D3,730
D,Paraguay,3,1,1,4,-3,D4,730
A,Peru,3,6,5,3,2,A1,731
A,Argentina,3,6,3,3,0,A2,731
A,Chile,3,3,3,3,0,A3,731
A,Canada,3,3,4,6,-2,A4,731
B,Mexico,3,7,9,3,6,B1,731
B,Ecuador,3,5,2,1,1,B2,731
B,Venezuela,3,3,2,4,-2,B3,731
B,Jamaica,3,1,2,7,-5,B4,731
C,Uruguay,3,7,5,3,2,C1,731
C,United States,3,6,6,2,4,C2,731
C,Panama,3,3,5,7,-2,C3,731
C,Bolivia,3,1,3,7,-4,C4,731
D,Paraguay,3,6,5,4,1,D1,731
D,Brazil,3,4,2,2,0,D2,731
D,Costa Rica,3,4,4,6,-2,D3,731
D,Colombia,3,3,6,5,1,D4,731
A,Peru,3,5,4,3,1,A1,732
A,Chile,3,5,2,1,1,A2,732
A,Argentina,3,2,2,3,-1,A3,732
A,Canada,3,2,2,3,-1,A4,732
B,Ecuador,3,9,7,4,3,B1,732
B,Jamaica,3,4,3,3,0,B2,732
B,Venezuela,3,4,2,2,0,B3,732
B,Mexico,3,0,1,4,-3,B4,732
C,Uruguay,3,7,5,3,2,C1,732
C,United States,3,5,6,3,3,C2,732
C,Bolivia,3,4,5,5,0,C3,732
C,Panama,3,0,0,5,-5,C4,732
D,Colombia,3,7,5,1,4,D1,732
D,Brazil,3,7,5,2,3,D2,732
D,Paraguay,3,3,2,5,-3,D3,732
D,Costa Rica,3,0,3,7,-4,D4,732
A,Argentina,3,9,9,0,9,A1,733
A,Chile,3,6,3,5,-2,A2,733
A,Peru,3,3,2,2,0,A3,733
A,Canada,3,0,1,8,-7,A4,733
B,Ecuador,3,9,10,1,9,B1,733
B,Mexico,3,6,2,3,-1,B2,733
B,Jamaica,3,3,4,3,1,B3,733
B,Venezuela,3,0,0,9,-9,B4,733
C,Uruguay,3,5,8,3,5,C1,733
C,Bolivia,3,4,4,3,1,C2,733
C,United States,3,4,5,5,0,C3,733
C,Panama,3,3,2,8,-6,C4,733
D,Brazil,3,7,7,2,5,D1,733
D,Colombia,3,7,7,2,5,D2,733
D,Paraguay,3,1,0,3,-3,D3,733
D,Costa Rica,3,1,0,7,-7,D4,733
A,Argentina,3,9,11,0,11,A1,734
A,Canada,3,4,2,5,-3,A2,734
A,Peru,3,3,2,7,-5,A3,734
A,Chile,3,1,0,3,-3,A4,734
B,Mexico,3,5,4,3,1,B1,734
B,Venezuela,3,4,4,4,0,B2,734
B,Jamaica,3,3,3,3,0,B3,734
B,Ecuador,3,2,3,4,-1,B4,734
C,United States,3,7,4,2,2,C1,734
C,Uruguay,3,5,6,3,3,C2,734
C,Bolivia,3,2,2,3,-1,C3,734
C,Panama,3,1,1,5,-4,C4,734
D,Colombia,3,9,5,1,4,D1,734
D,Brazil,3,4,5,3,2,D2,734
D,Costa Rica,3,2,4,5,-1,D3,734
D,Paraguay,3,1,2,7,-5,D4,734
A,Argentina,3,9,8,0,8,A1,735
A,Chile,3,3,2,3,-1,A2,735
A,Peru,3,3,2,4,-2,A3,735
A,Canada,3,3,3,8,-5,A4,735
B,Mexico,3,5,3,1,2,B1,735
B,Ecuador,3,4,3,2,1,B2,735
B,Venezuela,3,4,3,3,0,B3,735
B,Jamaica,3,3,2,5,-3,B4,735
C,Bolivia,3,6,5,5,0,C1,735
C,Uruguay,3,4,6,4,2,C2,735
C,United States,3,4,5,4,1,C3,735
C,Panama,3,3,2,5,-3,C4,735
D,Brazil,3,9,9,5,4,D1,735
D,Colombia,3,6,4,3,1,D2,735
D,Paraguay,3,1,3,5,-2,D3,735
D,Costa Rica,3,1,2,5,-3,D4,735
A,Argentina,3,9,8,3,5,A1,736
A,Chile,3,6,4,3,1,A2,736
A,Canada,3,3,5,5,0,A3,736
A,Peru,3,0,2,8,-6,A4,736
B,Mexico,3,6,6,3,3,B1,736
B,Ecuador,3,6,5,3,2,B2,736
B,Venezuela,3,6,6,7,-1,B3,736
B,Jamaica,3,0,1,5,-4,B4,736
C,United States,3,7,3,0,3,C1,736
C,Uruguay,3,4,6,2,4,C2,736
C,Panama,3,4,4,5,-1,C3,736
C,Bolivia,3,1,2,8,-6,C4,736
D,Brazil,3,9,10,1,9,D1,736
D,Colombia,3,6,4,2,2,D2,736
D,Costa Rica,3,3,3,7,-4,D3,736
D,Paraguay,3,0,3,10,-7,D4,736
A,Argentina,3,9,13,1,12,A1,737
A,Chile,3,4,3,7,-4,A2,737
A,Peru,3,3,3,6,-3,A3,737
A,Canada,3,1,1,6,-5,A4,737
B,Ecuador,3,7,2,0,2,B1,737
B,Mexico,3,4,2,1,1,B2,737
B,Venezuela,3,4,1,1,0,B3,737
B,Jamaica,3,1,0,3,-3,B4,737
C,United States,3,7,5,1,4,C1,737
C,Bolivia,3,5,6,5,1,C2,737
C,Uruguay,3,4,4,6,-2,C3,737
C,Panama,3,0,3,6,-3,C4,737
D,Brazil,3,6,6,4,2,D1,737
D,Colombia,3,6,5,4,1,D2,737
D,Paraguay,3,6,4,4,0,D3,737
D,Costa Rica,3,0,3,6,-3,D4,737
A,Argentina,3,9,5,1,4,A1,738
A,Canada,3,4,4,4,0,A2,738
A,Peru,3,2,1,3,-2,A3,738
A,Chile,3,1,1,3,-2,A4,738
B,Mexico,3,6,7,5,2,B1,738
B,Ecuador,3,6,4,2,2,B2,738
B,Venezuela,3,3,4,6,-2,B3,738
B,Jamaica,3,3,1,3,-2,B4,738
C,United States,3,9,5,2,3,C1,738
C,Bolivia,3,3,3,4,-1,C2,738
C,Panama,3,3,3,4,-1,C3,738
C,Uruguay,3,3,3,4,-1,C4,738
D,Colombia,3,9,8,1,7,D1,738
D,Brazil,3,4,5,3,2,D2,738
D,Costa Rica,3,3,2,9,-7,D3,738
D,Paraguay,3,1,1,3,-2,D4,738
A,Argentina,3,7,4,2,2,A1,739
A,Chile,3,5,4,3,1,A2,739
A,Peru,3,3,5,6,-1,A3,739
A,Canada,3,1,3,5,-2,A4,739
B,Mexico,3,7,5,1,4,B1,739
B,Venezuela,3,7,3,1,2,B2,739
B,Ecuador,3,1,1,4,-3,B3,739
B,Jamaica,3,1,1,4,-3,B4,739
C,United States,3,7,5,2,3,C1,739
C,Uruguay,3,5,3,2,1,C2,739
C,Panama,3,3,2,3,-1,C3,739
C,Bolivia,3,1,1,4,-3,C4,739
D,Brazil,3,7,7,2,5,D1,739
D,Colombia,3,4,4,3,1,D2,739
D,Costa Rica,3,4,3,6,-3,D3,739
D,Paraguay,3,1,2,5,-3,D4,739
A,Argentina,3,7,4,1,3,A1,740
A,Peru,3,6,2,2,0,A2,740
A,Chile,3,2,2,3,-1,A3,740
A,Canada,3,1,1,3,-2,A4,740
B,Jamaica,3,7,5,3,2,B1,740
B,Mexico,3,6,4,1,3,B2,740
B,Ecuador,3,3,2,3,-1,B3,740
B,Venezuela,3,1,2,6,-4,B4,740
C,United States,3,7,6,1,5,C1,740
C,Bolivia,3,7,3,0,3,C2,740
C,Uruguay,3,3,4,3,1,C3,740
C,Panama,3,0,1,10,-9,C4,740
D,Colombia,3,7,4,1,3,D1,740
D,Brazil,3,5,3,2,1,D2,740
D,Paraguay,3,2,2,3,-1,D3,740
D,Costa Rica,3,1,1,4,-3,D4,740
A,Argentina,3,7,6,1,5,A1,741
A,Peru,3,6,5,2,3,A2,741
A,Canada,3,4,4,6,-2,A3,741
A,Chile,3,0,1,7,-6,A4,741
B,Jamaica,3,7,5,2,3,B1,741
B,Ecuador,3,6,4,3,1,B2,741
B,Mexico,3,3,4,5,-1,B3,741
B,Venezuela,3,1,2,5,-3,B4,741
C,United States,3,7,7,3,4,C1,741
C,Panama,3,4,4,4,0,C2,741
C,Bolivia,3,4,2,4,-2,C3,741
C,Uruguay,3,1,1,3,-2,C4,741
D,Brazil,3,9,5,1,4,D1,741
D,Colombia,3,6,4,1,3,D2,741
D,Costa Rica,3,1,1,4,-3,D3,741
D,Paraguay,3,1,0,4,-4,D4,741
A,Peru,3,7,4,2,2,A1,742
A,Argentina,3,6,6,2,4,A2,742
A,Canada,3,4,1,1,0,A3,742
A,Chile,3,0,1,7,-6,A4,742
B,Venezuela,3,7,7,3,4,B1,742
B,Ecuador,3,4,6,6,0,B2,742
B,Jamaica,3,3,3,5,-2,B3,742
B,Mexico,3,3,3,5,-2,B4,742
C,United States,3,6,3,2,1,C1,742
C,Uruguay,3,5,4,2,2,C2,742
C,Bolivia,3,4,3,3,0,C3,742
C,Panama,3,1,2,5,-3,C4,742
D,Brazil,3,9,7,0,7,D1,742
D,Colombia,3,6,6,1,5,D2,742
D,Paraguay,3,3,1,8,-7,D3,742
D,Costa Rica,3,0,0,5,-5,D4,742
A,Argentina,3,6,6,2,4,A1,743
A,Chile,3,6,7,4,3,A2,743
A,Peru,3,6,5,2,3,A3,743
A,Canada,3,0,1,11,-10,A4,743
B,Venezuela,3,7,4,1,3,B1,743
B,Mexico,3,6,4,3,1,B2,743
B,Ecuador,3,4,2,3,-1,B3,743
B,Jamaica,3,0,1,4,-3,B4,743
C,Uruguay,3,7,5,2,3,C1,743
C,United States,3,4,3,2,1,C2,743
C,Bolivia,3,4,5,6,-1,C3,743
C,Panama,3,1,3,6,-3,C4,743
D,Brazil,3,9,11,4,7,D1,743
D,Colombia,3,4,3,3,0,D2,743
D,Paraguay,3,2,3,7,-4,D3,743
D,Costa Rica,3,1,3,6,-3,D4,743
A,Argentina,3,7,5,1,4,A1,744
A,Peru,3,6,5,4,1,A2,744
A,Chile,3,2,1,2,-1,A3,744
A,Canada,3,1,3,7,-4,A4,744
B,Venezuela,3,9,4,0,4,B1,744
B,Mexico,3,4,3,1,2,B2,744
B,Ecuador,3,4,2,3,-1,B3,744
B,Jamaica,3,0,1,6,-5,B4,744
C,Uruguay,3,9,9,0,9,C1,744
C,United States,3,6,5,3,2,C2,744
C,Panama,3,1,2,6,-4,C3,744
C,Bolivia,3,1,3,10,-7,C4,744
D,Brazil,3,7,6,3,3,D1,744
D,Costa Rica,3,4,3,4,-1,D2,744
D,Colombia,3,3,6,7,-1,D3,744
D,Paraguay,3,3,5,6,-1,D4,744
A,Argentina,3,9,6,0,6,A1,745
A,Canada,3,6,5,1,4,A2,745
A,Peru,3,1,0,3,-3,A3,745
A,Chile,3,1,0,7,-7,A4,745
B,Ecuador,3,7,4,2,2,B1,745
B,Mexico,3,5,1,0,1,B2,745
B,Jamaica,3,2,3,4,-1,B3,745
B,Venezuela,3,1,1,3,-2,B4,745
C,Panama,3,7,3,1,2,C1,745
C,Uruguay,3,5,2,1,1,C2,745
C,United States,3,4,2,1,1,C3,745
C,Bolivia,3,0,0,4,-4,C4,745
D,Brazil,3,9,13,0,13,D1,745
D,Colombia,3,6,3,2,1,D2,745
D,Paraguay,3,3,1,9,-8,D3,745
D,Costa Rica,3,0,1,7,-6,D4,745
A,Argentina,3,5,5,3,2,A1,746
A,Peru,3,5,5,3,2,A2,746
A,Chile,3,3,4,4,0,A3,746
A,Canada,3,1,2,6,-4,A4,746
B,Jamaica,3,6,3,3,0,B1,746
B,Mexico,3,4,4,3,1,B2,746
B,Ecuador,3,4,2,2,0,B3,746
B,Venezuela,3,2,0,1,-1,B4,746
C,Uruguay,3,6,6,4,2,C1,746
C,United States,3,4,8,6,2,C2,746
C,Bolivia,3,4,2,2,0,C3,746
C,Panama,3,3,3,7,-4,C4,746
D,Brazil,3,9,8,2,6,D1,746
D,Paraguay,3,4,2,2,0,D2,746
D,Colombia,3,3,2,4,-2,D3,746
D,Costa Rica,3,1,0,4,-4,D4,746
A,Argentina,3,9,9,3,6,A1,747
A,Peru,3,6,5,5,0,A2,747
A,Canada,3,1,4,7,-3,A3,747
A,Chile,3,1,4,7,-3,A4,747
B,Mexico,3,9,10,1,9,B1,747
B,Ecuador,3,4,3,3,0,B2,747
B,Venezuela,3,2,2,8,-6,B3,747
B,Jamaica,3,1,1,4,-3,B4,747
C,Uruguay,3,7,7,3,4,C1,747
C,United States,3,6,7,6,1,C2,747
C,Bolivia,3,4,2,4,-2,C3,747
C,Panama,3,0,3,6,-3,C4,747
D,Colombia,3,7,7,1,6,D1,747
D,Brazil,3,5,1,0,1,D2,747
D,Paraguay,3,3,3,6,-3,D3,747
D,Costa Rica,3,1,1,5,-4,D4,747
A,Argentina,3,7,6,3,3,A1,748
A,Chile,3,4,4,3,1,A2,748
A,Peru,3,4,4,4,0,A3,748
A,Canada,3,1,1,5,-4,A4,748
B,Mexico,3,9,5,1,4,B1,748
B,Jamaica,3,4,2,2,0,B2,748
B,Venezuela,3,2,0,1,-1,B3,748
B,Ecuador,3,1,1,4,-3,B4,748
C,Uruguay,3,6,6,2,4,C1,748
C,United States,3,5,3,2,1,C2,748
C,Panama,3,4,4,2,2,C3,748
C,Bolivia,3,1,1,8,-7,C4,748
D,Colombia,3,7,4,2,2,D1,748
D,Paraguay,3,6,2,1,1,D2,748
D,Brazil,3,2,2,3,-1,D3,748
D,Costa Rica,3,1,2,4,-2,D4,748
A,Argentina,3,9,5,1,4,A1,749
A,Canada,3,6,5,4,1,A2,749
A,Peru,3,3,3,4,-1,A3,749
A,Chile,3,0,0,4,-4,A4,749
B,Ecuador,3,7,8,3,5,B1,749
B,Mexico,3,7,4,1,3,B2,749
B,Venezuela,3,1,2,6,-4,B3,749
B,Jamaica,3,1,0,4,-4,B4,749
C,Uruguay,3,7,5,3,2,C1,749
C,United States,3,5,6,2,4,C2,749
C,Panama,3,3,3,6,-3,C3,749
C,Bolivia,3,1,2,5,-3,C4,749
D,Brazil,3,6,4,2,2,D1,749
D,Colombia,3,6,3,1,2,D2,749
D,Paraguay,3,3,2,3,-1,D3,749
D,Costa Rica,3,3,1,4,-3,D4,749
A,Canada,3,7,4,0,4,A1,750
A,Argentina,3,3,1,1,0,A2,750
A,Peru,3,2,1,3,-2,A3,750
A,Chile,3,2,0,2,-2,A4,750
B,Mexico,3,7,2,0,2,B1,750
B,Venezuela,3,6,5,4,1,B2,750
B,Jamaica,3,3,4,5,-1,B3,750
B,Ecuador,3,1,2,4,-2,B4,750
C,Bolivia,3,7,8,3,5,C1,750
C,Uruguay,3,7,6,3,3,C2,750
C,United States,3,3,2,4,-2,C3,750
C,Panama,3,0,2,8,-6,C4,750
D,Brazil,3,9,5,2,3,D1,750
D,Colombia,3,4,3,3,0,D2,750
D,Paraguay,3,3,4,4,0,D3,750
D,Costa Rica,3,1,4,7,-3,D4,750
A,Chile,3,6,7,4,3,A1,751
A,Canada,3,6,5,2,3,A2,751
A,Argentina,3,3,2,4,-2,A3,751
A,Peru,3,3,1,5,-4,A4,751
B,Mexico,3,9,7,1,6,B1,751
B,Ecuador,3,4,4,3,1,B2,751
B,Venezuela,3,4,2,3,-1,B3,751
B,Jamaica,3,0,1,7,-6,B4,751
C,United States,3,7,4,2,2,C1,751
C,Uruguay,3,6,6,3,3,C2,751
C,Bolivia,3,4,4,3,1,C3,751
C,Panama,3,0,0,6,-6,C4,751
D,Brazil,3,9,8,1,7,D1,751
D,Colombia,3,6,5,5,0,D2,751
D,Paraguay,3,3,4,5,-1,D3,751
D,Costa Rica,3,0,2,8,-6,D4,751
A,Argentina,3,7,5,0,5,A1,752
A,Peru,3,5,2,1,1,A2,752
A,Canada,3,2,3,6,-3,A3,752
A,Chile,3,1,2,5,-3,A4,752
B,Ecuador,3,9,8,1,7,B1,752
B,Venezuela,3,6,5,3,2,B2,752
B,Mexico,3,3,4,5,-1,B3,752
B,Jamaica,3,0,2,10,-8,B4,752
C,United States,3,9,8,1,7,C1,752
C,Panama,3,4,2,6,-4,C2,752
C,Uruguay,3,2,4,5,-1,C3,752
C,Bolivia,3,1,2,4,-2,C4,752
D,Colombia,3,7,8,0,8,D1,752
D,Brazil,3,6,7,2,5,D2,752
D,Paraguay,3,2,0,4,-4,D3,752
D,Costa Rica,3,1,1,10,-9,D4,752
A,Argentina,3,7,8,3,5,A1,753
A,Peru,3,4,5,6,-1,A2,753
A,Canada,3,3,5,8,-3,A3,753
A,Chile,3,2,3,4,-1,A4,753
B,Venezuela,3,7,4,0,4,B1,753
B,Mexico,3,7,3,0,3,B2,753
B,Ecuador,3,3,3,4,-1,B3,753
B,Jamaica,3,0,0,6,-6,B4,753
C,United States,3,7,7,0,7,C1,753
C,Uruguay,3,5,4,2,2,C2,753
C,Bolivia,3,3,5,11,-6,C3,753
C,Panama,3,1,2,5,-3,C4,753
D,Brazil,3,9,6,0,6,D1,753
D,Paraguay,3,6,2,2,0,D2,753
D,Costa Rica,3,3,2,4,-2,D3,753
D,Colombia,3,0,1,5,-4,D4,753
A,Argentina,3,9,6,2,4,A1,754
A,Chile,3,4,3,2,1,A2,754
A,Canada,3,2,2,4,-2,A3,754
A,Peru,3,1,1,4,-3,A4,754
B,Mexico,3,7,4,1,3,B1,754
B,Ecuador,3,4,2,2,0,B2,754
B,Jamaica,3,3,0,0,0,B3,754
B,Venezuela,3,1,0,3,-3,B4,754
C,Uruguay,3,6,8,3,5,C1,754
C,Panama,3,6,5,4,1,C2,754
C,United States,3,6,4,3,1,C3,754
C,Bolivia,3,0,1,8,-7,C4,754
D,Brazil,3,7,6,1,5,D1,754
D,Colombia,3,4,5,6,-1,D2,754
D,Costa Rica,3,3,2,5,-3,D3,754
D,Paraguay,3,2,5,6,-1,D4,754
A,Argentina,3,6,4,2,2,A1,755
A,Peru,3,5,3,2,1,A2,755
A,Chile,3,4,3,3,0,A3,755
A,Canada,3,1,0,3,-3,A4,755
B,Ecuador,3,7,3,1,2,B1,755
B,Mexico,3,4,2,1,1,B2,755
B,Jamaica,3,3,2,3,-1,B3,755
B,Venezuela,3,3,2,4,-2,B4,755
C,Uruguay,3,9,7,2,5,C1,755
C,United States,3,6,5,2,3,C2,755
C,Bolivia,3,3,4,6,-2,C3,755
C,Panama,3,0,2,8,-6,C4,755
D,Costa Rica,3,7,4,1,3,D1,755
D,Brazil,3,4,3,3,0,D2,755
D,Colombia,3,3,2,3,-1,D3,755
D,Paraguay,3,3,3,5,-2,D4,755
A,Chile,3,6,6,4,2,A1,756
A,Peru,3,4,3,2,1,A2,756
A,Argentina,3,4,4,4,0,A3,756
A,Canada,3,2,2,5,-3,A4,756
B,Mexico,3,9,8,1,7,B1,756
B,Ecuador,3,6,5,3,2,B2,756
B,Venezuela,3,1,3,5,-2,B3,756
B,Jamaica,3,1,2,9,-7,B4,756
C,United States,3,6,4,2,2,C1,756
C,Uruguay,3,6,3,2,1,C2,756
C,Bolivia,3,3,3,3,0,C3,756
C,Panama,3,3,2,5,-3,C4,756
D,Brazil,3,9,11,1,10,D1,756
D,Colombia,3,6,4,6,-2,D2,756
D,Paraguay,3,1,3,6,-3,D3,756
D,Costa Rica,3,1,1,6,-5,D4,756
A,Chile,3,5,4,3,1,A1,757
A,Peru,3,5,3,2,1,A2,757
A,Argentina,3,4,5,4,1,A3,757
A,Canada,3,1,4,7,-3,A4,757
B,Mexico,3,7,4,0,4,B1,757
B,Jamaica,3,7,2,0,2,B2,757
B,Venezuela,3,3,1,2,-1,B3,757
B,Ecuador,3,0,0,5,-5,B4,757
C,United States,3,9,7,0,7,C1,757
C,Uruguay,3,6,5,4,1,C2,757
C,Bolivia,3,3,3,7,-4,C3,757
C,Panama,3,0,1,5,-4,C4,757
D,Colombia,3,7,4,0,4,D1,757
D,Brazil,3,7,3,0,3,D2,757
D,Paraguay,3,1,1,3,-2,D3,757
D,Costa Rica,3,1,1,6,-5,D4,757
A,Peru,3,7,3,1,2,A1,758
A,Argentina,3,5,7,2,5,A2,758
A,Canada,3,2,3,4,-1,A3,758
A,Chile,3,1,2,8,-6,A4,758
B,Mexico,3,7,5,1,4,B1,758
B,Venezuela,3,4,1,2,-1,B2,758
B,Ecuador,3,2,1,2,-1,B3,758
B,Jamaica,3,2,2,4,-2,B4,758
C,United States,3,7,4,0,4,C1,758
C,Uruguay,3,7,6,4,2,C2,758
C,Bolivia,3,1,4,7,-3,C3,758
C,Panama,3,1,4,7,-3,C4,758
D,Brazil,3,5,2,0,2,D1,758
D,Paraguay,3,4,2,3,-1,D2,758
D,Costa Rica,3,3,1,1,0,D3,758
D,Colombia,3,2,0,1,-1,D4,758
A,Argentina,3,6,7,1,6,A1,759
A,Peru,3,4,2,2,0,A2,759
A,Chile,3,4,5,7,-2,A3,759
A,Canada,3,3,2,6,-4,A4,759
B,Mexico,3,6,2,1,1,B1,759
B,Venezuela,3,6,2,2,0,B2,759
B,Ecuador,3,3,2,2,0,B3,759
B,Jamaica,3,3,2,3,-1,B4,759
C,United States,3,9,10,3,7,C1,759
C,Uruguay,3,6,7,4,3,C2,759
C,Bolivia,3,3,3,8,-5,C3,759
C,Panama,3,0,2,7,-5,C4,759
D,Brazil,3,9,8,0,8,D1,759
D,Colombia,3,4,4,3,1,D2,759
D,Costa Rica,3,2,1,4,-3,D3,759
D,Paraguay,3,1,1,7,-6,D4,759
A,Argentina,3,9,8,1,7,A1,760
A,Chile,3,6,5,4,1,A2,760
A,Canada,3,3,3,6,-3,A3,760
A,Peru,3,0,2,7,-5,A4,760
B,Mexico,3,7,5,2,3,B1,760
B,Jamaica,3,4,2,3,-1,B2,760
B,Venezuela,3,3,3,3,0,B3,760
B,Ecuador,3,1,2,4,-2,B4,760
C,United States,3,9,7,2,5,C1,760
C,Uruguay,3,4,3,4,-1,C2,760
C,Panama,3,3,4,6,-2,C3,760
C,Bolivia,3,1,3,5,-2,C4,760
D,Brazil,3,9,6,1,5,D1,760
D,Colombia,3,4,4,3,1,D2,760
D,Costa Rica,3,3,3,6,-3,D3,760
D,Paraguay,3,1,3,6,-3,D4,760
A,Argentina,3,9,6,1,5,A1,761
A,Chile,3,3,3,3,0,A2,761
A,Canada,3,3,4,6,-2,A3,761
A,Peru,3,3,3,6,-3,A4,761
B,Mexico,3,5,5,4,1,B1,761
B,Ecuador,3,5,4,3,1,B2,761
B,Venezuela,3,3,4,4,0,B3,761
B,Jamaica,3,1,3,5,-2,B4,761
C,United States,3,9,6,2,4,C1,761
C,Uruguay,3,6,5,1,4,C2,761
C,Bolivia,3,1,2,5,-3,C3,761
C,Panama,3,1,4,9,-5,C4,761
D,Brazil,3,9,10,2,8,D1,761
D,Costa Rica,3,4,3,5,-2,D2,761
D,Colombia,3,3,3,3,0,D3,761
D,Paraguay,3,1,1,7,-6,D4,761
A,Argentina,3,5,6,1,5,A1,762
A,Chile,3,4,3,3,0,A2,762
A,Canada,3,4,1,3,-2,A3,762
A,Peru,3,3,4,7,-3,A4,762
B,Ecuador,3,7,4,1,3,B1,762
B,Mexico,3,6,5,3,2,B2,762
B,Venezuela,3,3,2,4,-2,B3,762
B,Jamaica,3,1,0,3,-3,B4,762
C,Uruguay,3,7,9,3,6,C1,762
C,United States,3,7,6,0,6,C2,762
C,Bolivia,3,3,2,6,-4,C3,762
C,Panama,3,0,3,11,-8,C4,762
D,Brazil,3,9,5,0,5,D1,762
D,Colombia,3,4,3,3,0,D2,762
D,Costa Rica,3,2,1,3,-2,D3,762
D,Paraguay,3,1,0,3,-3,D4,762
A,Argentina,3,9,6,3,3,A1,763
A,Chile,3,6,8,3,5,A2,763
A,Canada,3,3,3,7,-4,A3,763
A,Peru,3,0,3,7,-4,A4,763
B,Mexico,3,7,5,2,3,B1,763
B,Ecuador,3,4,5,5,0,B2,763
B,Venezuela,3,4,1,2,-1,B3,763
B,Jamaica,3,1,2,4,-2,B4,763
C,United States,3,7,5,0,5,C1,763
C,Uruguay,3,4,5,3,2,C2,763
C,Panama,3,4,4,3,1,C3,763
C,Bolivia,3,1,1,9,-8,C4,763
D,Colombia,3,9,7,3,4,D1,763
D,Brazil,3,4,6,4,2,D2,763
D,Paraguay,3,2,2,3,-1,D3,763
D,Costa Rica,3,1,2,7,-5,D4,763
A,Argentina,3,6,7,3,4,A1,764
A,Peru,3,5,4,3,1,A2,764
A,Chile,3,4,4,4,0,A3,764
A,Canada,3,1,3,8,-5,A4,764
B,Venezuela,3,6,6,3,3,B1,764
B,Mexico,3,4,1,1,0,B2,764
B,Jamaica,3,4,5,7,-2,B3,764
B,Ecuador,3,3,6,7,-1,B4,764
C,United States,3,7,7,0,7,C1,764
C,Panama,3,7,3,0,3,C2,764
C,Bolivia,3,1,0,4,-4,C3,764
C,Uruguay,3,1,0,6,-6,C4,764
D,Brazil,3,9,7,0,7,D1,764
D,Colombia,3,6,4,1,3,D2,764
D,Paraguay,3,3,2,5,-3,D3,764
D,Costa Rica,3,0,0,7,-7,D4,764
A,Argentina,3,9,5,1,4,A1,765
A,Peru,3,4,3,3,0,A2,765
A,Chile,3,2,2,3,-1,A3,765
A,Canada,3,1,2,5,-3,A4,765
B,Ecuador,3,7,7,3,4,B1,765
B,Mexico,3,5,4,3,1,B2,765
B,Jamaica,3,2,3,5,-2,B3,765
B,Venezuela,3,1,1,4,-3,B4,765
C,Uruguay,3,9,7,1,6,C1,765
C,Panama,3,4,3,4,-1,C2,765
C,United States,3,3,5,6,-1,C3,765
C,Bolivia,3,1,3,7,-4,C4,765
D,Brazil,3,7,8,2,6,D1,765
D,Colombia,3,4,2,2,0,D2,765
D,Paraguay,3,3,2,3,-1,D3,765
D,Costa Rica,3,3,1,6,-5,D4,765
A,Argentina,3,6,5,4,1,A1,766
A,Chile,3,5,4,2,2,A2,766
A,Canada,3,4,3,4,-1,A3,766
A,Peru,3,1,0,2,-2,A4,766
B,Ecuador,3,5,6,5,1,B1,766
B,Jamaica,3,4,4,4,0,B2,766
B,Venezuela,3,4,2,4,-2,B3,766
B,Mexico,3,3,6,5,1,B4,766
C,Uruguay,3,9,8,2,6,C1,766
C,United States,3,6,6,1,5,C2,766
C,Bolivia,3,3,4,10,-6,C3,766
C,Panama,3,0,1,6,-5,C4,766
D,Brazil,3,7,8,3,5,D1,766
D,Colombia,3,3,3,3,0,D2,766
D,Costa Rica,3,2,2,4,-2,D3,766
D,Paraguay,3,2,2,5,-3,D4,766
A,Argentina,3,6,7,4,3,A1,767
A,Canada,3,6,8,7,1,A2,767
A,Chile,3,3,5,6,-1,A3,767
A,Peru,3,3,4,7,-3,A4,767
B,Venezuela,3,6,8,4,4,B1,767
B,Ecuador,3,5,6,5,1,B2,767
B,Mexico,3,4,5,3,2,B3,767
B,Jamaica,3,1,1,8,-7,B4,767
C,United States,3,7,5,2,3,C1,767
C,Bolivia,3,6,5,3,2,C2,767
C,Uruguay,3,2,1,3,-2,C3,767
C,Panama,3,1,1,4,-3,C4,767
D,Brazil,3,7,4,0,4,D1,767
D,Colombia,3,7,4,1,3,D2,767
D,Paraguay,3,3,2,5,-3,D3,767
D,Costa Rica,3,0,1,5,-4,D4,767
A,Chile,3,9,7,3,4,A1,768
A,Argentina,3,6,6,3,3,A2,768
A,Peru,3,3,2,5,-3,A3,768
A,Canada,3,0,2,6,-4,A4,768
B,Mexico,3,6,7,6,1,B1,768
B,Ecuador,3,6,6,5,1,B2,768
B,Jamaica,3,4,2,2,0,B3,768
B,Venezuela,3,1,2,4,-2,B4,768
C,Uruguay,3,9,3,0,3,C1,768
C,United States,3,6,5,2,3,C2,768
C,Panama,3,3,2,4,-2,C3,768
C,Bolivia,3,0,0,4,-4,C4,768
D,Brazil,3,9,7,1,6,D1,768
D,Colombia,3,6,3,2,1,D2,768
D,Costa Rica,3,3,2,5,-3,D3,768
D,Paraguay,3,0,1,5,-4,D4,768
A,Chile,3,9,8,1,7,A1,769
A,Argentina,3,4,1,1,0,A2,769
A,Canada,3,3,2,4,-2,A3,769
A,Peru,3,1,2,7,-5,A4,769
B,Mexico,3,7,5,2,3,B1,769
B,Ecuador,3,4,4,3,1,B2,769
B,Jamaica,3,2,2,4,-2,B3,769
B,Venezuela,3,2,2,4,-2,B4,769
C,Uruguay,3,9,7,2,5,C1,769
C,United States,3,6,5,3,2,C2,769
C,Bolivia,3,3,2,3,-1,C3,769
C,Panama,3,0,0,6,-6,C4,769
D,Brazil,3,9,7,2,5,D1,769
D,Colombia,3,4,2,2,0,D2,769
D,Costa Rica,3,2,0,3,-3,D3,769
D,Paraguay,3,1,1,3,-2,D4,769
A,Argentina,3,7,6,1,5,A1,770
A,Chile,3,4,2,2,0,A2,770
A,Peru,3,3,2,4,-2,A3,770
A,Canada,3,3,3,6,-3,A4,770
B,Ecuador,3,9,6,3,3,B1,770
B,Mexico,3,6,9,5,4,B2,770
B,Jamaica,3,3,2,5,-3,B3,770
B,Venezuela,3,0,2,6,-4,B4,770
C,Uruguay,3,7,7,5,2,C1,770
C,United States,3,6,3,2,1,C2,770
C,Panama,3,3,3,4,-1,C3,770
C,Bolivia,3,1,4,6,-2,C4,770
D,Brazil,3,9,7,1,6,D1,770
D,Colombia,3,6,8,3,5,D2,770
D,Paraguay,3,1,1,5,-4,D3,770
D,Costa Rica,3,1,0,7,-7,D4,770
A,Argentina,3,9,8,3,5,A1,771
A,Peru,3,6,7,6,1,A2,771
A,Canada,3,3,5,5,0,A3,771
A,Chile,3,0,3,9,-6,A4,771
B,Mexico,3,7,6,3,3,B1,771
B,Venezuela,3,6,4,3,1,B2,771
B,Jamaica,3,4,2,3,-1,B3,771
B,Ecuador,3,0,1,4,-3,B4,771
C,Panama,3,5,5,3,2,C1,771
C,Uruguay,3,4,6,6,0,C2,771
C,United States,3,4,3,4,-1,C3,771
C,Bolivia,3,2,3,4,-1,C4,771
D,Brazil,3,9,5,1,4,D1,771
D,Colombia,3,6,4,3,1,D2,771
D,Costa Rica,3,3,3,4,-1,D3,771
D,Paraguay,3,0,0,4,-4,D4,771
A,Argentina,3,9,11,3,8,A1,772
A,Peru,3,4,5,3,2,A2,772
A,Chile,3,2,3,6,-3,A3,772
A,Canada,3,1,4,11,-7,A4,772
B,Venezuela,3,6,9,3,6,B1,772
B,Jamaica,3,6,2,4,-2,B2,772
B,Ecuador,3,4,3,3,0,B3,772
B,Mexico,3,1,0,4,-4,B4,772
C,Uruguay,3,9,7,2,5,C1,772
C,United States,3,4,7,4,3,C2,772
C,Bolivia,3,3,5,8,-3,C3,772
C,Panama,3,1,3,8,-5,C4,772
D,Brazil,3,7,5,1,4,D1,772
D,Colombia,3,5,1,0,1,D2,772
D,Costa Rica,3,3,2,2,0,D3,772
D,Paraguay,3,1,1,6,-5,D4,772
A,Argentina,3,9,6,0,6,A1,773
A,Chile,3,4,2,2,0,A2,773
A,Peru,3,3,3,5,-2,A3,773
A,Canada,3,1,1,5,-4,A4,773
B,Mexico,3,9,6,1,5,B1,773
B,Ecuador,3,4,3,1,2,B2,773
B,Venezuela,3,2,1,2,-1,B3,773
B,Jamaica,3,1,0,6,-6,B4,773
C,Uruguay,3,7,7,4,3,C1,773
C,United States,3,7,4,1,3,C2,773
C,Panama,3,1,3,6,-3,C3,773
C,Bolivia,3,1,2,5,-3,C4,773
D,Colombia,3,6,5,3,2,D1,773
D,Paraguay,3,6,3,3,0,D2,773
D,Brazil,3,4,3,3,0,D3,773
D,Costa Rica,3,1,1,3,-2,D4,773
A,Canada,3,7,3,1,2,A1,774
A,Argentina,3,4,3,2,1,A2,774
A,Peru,3,2,2,3,-1,A3,774
A,Chile,3,2,0,2,-2,A4,774
B,Mexico,3,7,5,0,5,B1,774
B,Jamaica,3,4,2,2,0,B2,774
B,Ecuador,3,4,3,5,-2,B3,774
B,Venezuela,3,1,1,4,-3,B4,774
C,Uruguay,3,7,6,2,4,C1,774
C,Bolivia,3,4,4,4,0,C2,774
C,United States,3,4,2,3,-1,C3,774
C,Panama,3,1,3,6,-3,C4,774
D,Brazil,3,9,7,1,6,D1,774
D,Colombia,3,4,4,3,1,D2,774
D,Costa Rica,3,3,3,7,-4,D3,774
D,Paraguay,3,1,2,5,-3,D4,774
A,Argentina,3,9,10,0,10,A1,775
A,Chile,3,6,6,5,1,A2,775
A,Canada,3,3,3,8,-5,A3,775
A,Peru,3,0,2,8,-6,A4,775
B,Venezuela,3,4,6,5,1,B1,775
B,Ecuador,3,4,7,7,0,B2,775
B,Mexico,3,4,6,7,-1,B3,775
B,Jamaica,3,3,3,3,0,B4,775
C,United States,3,5,2,1,1,C1,775
C,Uruguay,3,4,2,1,1,C2,775
C,Bolivia,3,4,2,3,-1,C3,775
C,Panama,3,3,2,3,-1,C4,775
D,Brazil,3,7,11,3,8,D1,775
D,Colombia,3,5,5,3,2,D2,775
D,Costa Rica,3,2,5,11,-6,D3,775
D,Paraguay,3,1,3,7,-4,D4,775
A,Peru,3,6,3,2,1,A1,776
A,Chile,3,6,2,1,1,A2,776
A,Argentina,3,4,2,2,0,A3,776
A,Canada,3,1,0,2,-2,A4,776
B,Mexico,3,7,5,3,2,B1,776
B,Ecuador,3,4,4,4,0,B2,776
B,Jamaica,3,3,2,2,0,B3,776
B,Venezuela,3,1,0,2,-2,B4,776
C,Uruguay,3,7,7,3,4,C1,776
C,United States,3,6,10,3,7,C2,776
C,Bolivia,3,4,3,7,-4,C3,776
C,Panama,3,0,1,8,-7,C4,776
D,Brazil,3,7,4,1,3,D1,776
D,Colombia,3,6,4,3,1,D2,776
D,Costa Rica,3,2,1,2,-1,D3,776
D,Paraguay,3,1,1,4,-3,D4,776
A,Argentina,3,7,7,3,4,A1,777
A,Canada,3,4,3,4,-1,A2,777
A,Chile,3,3,4,4,0,A3,777
A,Peru,3,1,1,4,-3,A4,777
B,Ecuador,3,7,8,4,4,B1,777
B,Mexico,3,6,5,4,1,B2,777
B,Venezuela,3,2,3,5,-2,B3,777
B,Jamaica,3,1,3,6,-3,B4,777
C,Uruguay,3,7,3,1,2,C1,777
C,Bolivia,3,4,5,3,2,C2,777
C,United States,3,2,4,5,-1,C3,777
C,Panama,3,2,1,4,-3,C4,777
D,Paraguay,3,7,3,1,2,D1,777
D,Colombia,3,6,3,2,1,D2,777
D,Brazil,3,3,3,3,0,D3,777
D,Costa Rica,3,1,3,6,-3,D4,777
A,Argentina,3,9,4,0,4,A1,778
A,Chile,3,4,6,3,3,A2,778
A,Canada,3,2,2,3,-1,A3,778
A,Peru,3,1,0,6,-6,A4,778
B,Ecuador,3,7,4,2,2,B1,778
B,Jamaica,3,5,4,3,1,B2,778
B,Mexico,3,4,5,4,1,B3,778
B,Venezuela,3,0,0,4,-4,B4,778
C,Uruguay,3,9,5,0,5,C1,778
C,United States,3,4,2,2,0,C2,778
C,Panama,3,2,2,4,-2,C3,778
C,Bolivia,3,1,1,4,-3,C4,778
D,Brazil,3,7,2,0,2,D1,778
D,Colombia,3,6,6,1,5,D2,778
D,Costa Rica,3,2,0,5,-5,D3,778
D,Paraguay,3,1,0,2,-2,D4,778
A,Argentina,3,9,6,3,3,A1,779
A,Chile,3,6,5,4,1,A2,779
A,Peru,3,3,4,4,0,A3,779
A,Canada,3,0,2,6,-4,A4,779
B,Mexico,3,5,6,4,2,B1,779
B,Venezuela,3,4,5,6,-1,B2,779
B,Ecuador,3,3,3,3,0,B3,779
B,Jamaica,3,2,3,4,-1,B4,779
C,Uruguay,3,6,11,5,6,C1,779
C,Bolivia,3,6,5,2,3,C2,779
C,United States,3,3,4,7,-3,C3,779
C,Panama,3,3,3,9,-6,C4,779
D,Brazil,3,9,10,1,9,D1,779
D,Colombia,3,6,5,3,2,D2,779
D,Paraguay,3,3,4,7,-3,D3,779
D,Costa Rica,3,0,1,9,-8,D4,779
A,Chile,3,5,4,1,3,A1,780
A,Peru,3,5,3,1,2,A2,780
A,Argentina,3,5,2,1,1,A3,780
A,Canada,3,0,1,7,-6,A4,780
B,Ecuador,3,5,2,1,1,B1,780
B,Mexico,3,4,5,3,2,B2,780
B,Venezuela,3,4,2,4,-2,B3,780
B,Jamaica,3,2,0,1,-1,B4,780
C,Panama,3,7,5,3,2,C1,780
C,Uruguay,3,6,9,5,4,C2,780
C,United States,3,4,7,4,3,C3,780
C,Bolivia,3,0,0,9,-9,C4,780
D,Brazil,3,9,5,0,5,D1,780
D,Costa Rica,3,2,2,3,-1,D2,780
D,Colombia,3,2,2,4,-2,D3,780
D,Paraguay,3,2,2,4,-2,D4,780
A,Argentina,3,7,6,1,5,A1,781
A,Canada,3,4,3,5,-2,A2,781
A,Peru,3,3,3,3,0,A3,781
A,Chile,3,1,2,5,-3,A4,781
B,Venezuela,3,4,2,1,1,B1,781
B,Ecuador,3,4,2,2,0,B2,781
B,Jamaica,3,4,1,1,0,B3,781
B,Mexico,3,4,2,3,-1,B4,781
C,Uruguay,3,9,7,0,7,C1,781
C,United States,3,6,4,1,3,C2,781
C,Panama,3,3,2,5,-3,C3,781
C,Bolivia,3,0,0,7,-7,C4,781
D,Brazil,3,7,5,3,2,D1,781
D,Colombia,3,5,4,3,1,D2,781
D,Paraguay,3,4,5,4,1,D3,781
D,Costa Rica,3,0,1,5,-4,D4,781
A,Argentina,3,7,7,2,5,A1,782
A,Chile,3,7,6,4,2,A2,782
A,Peru,3,1,2,5,-3,A3,782
A,Canada,3,1,2,6,-4,A4,782
B,Mexico,3,6,3,3,0,B1,782
B,Venezuela,3,5,9,6,3,B2,782
B,Ecuador,3,4,7,6,1,B3,782
B,Jamaica,3,1,5,9,-4,B4,782
C,United States,3,9,9,1,8,C1,782
C,Panama,3,6,3,1,2,C2,782
C,Uruguay,3,3,1,3,-2,C3,782
C,Bolivia,3,0,1,9,-8,C4,782
D,Colombia,3,9,6,0,6,D1,782
D,Brazil,3,6,4,1,3,D2,782
D,Costa Rica,3,1,0,4,-4,D3,782
D,Paraguay,3,1,0,5,-5,D4,782
A,Peru,3,7,5,3,2,A1,783
A,Argentina,3,5,5,2,3,A2,783
A,Chile,3,3,1,4,-3,A3,783
A,Canada,3,1,3,5,-2,A4,783
B,Mexico,3,7,2,0,2,B1,783
B,Ecuador,3,6,2,1,1,B2,783
B,Venezuela,3,4,1,1,0,B3,783
B,Jamaica,3,0,0,3,-3,B4,783
C,Panama,3,5,3,1,2,C1,783
C,Uruguay,3,5,3,1,2,C2,783
C,United States,3,5,3,2,1,C3,783
C,Bolivia,3,0,2,7,-5,C4,783
D,Brazil,3,7,4,1,3,D1,783
D,Colombia,3,5,2,0,2,D2,783
D,Costa Rica,3,3,1,4,-3,D3,783
D,Paraguay,3,1,1,3,-2,D4,783
A,Canada,3,6,7,3,4,A1,784
A,Argentina,3,4,2,2,0,A2,784
A,Peru,3,4,2,3,-1,A3,784
A,Chile,3,3,2,5,-3,A4,784
B,Ecuador,3,9,7,3,4,B1,784
B,Venezuela,3,3,5,5,0,B2,784
B,Mexico,3,3,3,4,-1,B3,784
B,Jamaica,3,3,2,5,-3,B4,784
C,Uruguay,3,9,10,2,8,C1,784
C,United States,3,4,7,5,2,C2,784
C,Panama,3,2,4,8,-4,C3,784
C,Bolivia,3,1,5,11,-6,C4,784
D,Brazil,3,9,10,1,9,D1,784
D,Colombia,3,6,5,3,2,D2,784
D,Paraguay,3,3,2,6,-4,D3,784
D,Costa Rica,3,0,0,7,-7,D4,784
A,Argentina,3,7,8,3,5,A1,785
A,Canada,3,5,5,4,1,A2,785
A,Peru,3,4,8,8,0,A3,785
A,Chile,3,0,2,8,-6,A4,785
B,Mexico,3,6,7,5,2,B1,785
B,Ecuador,3,5,5,3,2,B2,785
B,Venezuela,3,2,7,9,-2,B3,785
B,Jamaica,3,2,3,5,-2,B4,785
C,United States,3,7,9,3,6,C1,785
C,Uruguay,3,5,4,3,1,C2,785
C,Bolivia,3,2,2,4,-2,C3,785
C,Panama,3,1,2,7,-5,C4,785
D,Colombia,3,9,8,1,7,D1,785
D,Brazil,3,4,2,2,0,D2,785
D,Paraguay,3,4,2,3,-1,D3,785
D,Costa Rica,3,0,1,7,-6,D4,785
A,Argentina,3,9,4,0,4,A1,786
A,Canada,3,3,5,4,1,A2,786
A,Chile,3,3,3,5,-2,A3,786
A,Peru,3,3,2,5,-3,A4,786
B,Ecuador,3,9,5,0,5,B1,786
B,Venezuela,3,6,7,4,3,B2,786
B,Mexico,3,3,2,5,-3,B3,786
B,Jamaica,3,0,0,5,-5,B4,786
C,Bolivia,3,5,5,3,2,C1,786
C,United States,3,5,7,6,1,C2,786
C,Uruguay,3,3,5,5,0,C3,786
C,Panama,3,1,4,7,-3,C4,786
D,Colombia,3,7,4,2,2,D1,786
D,Brazil,3,6,7,4,3,D2,786
D,Costa Rica,3,3,3,4,-1,D3,786
D,Paraguay,3,1,2,6,-4,D4,786
A,Argentina,3,9,8,1,7,A1,787
A,Peru,3,4,3,4,-1,A2,787
A,Canada,3,2,2,4,-2,A3,787
A,Chile,3,1,1,5,-4,A4,787
B,Jamaica,3,7,5,3,2,B1,787
B,Ecuador,3,4,7,4,3,B2,787
B,Mexico,3,4,5,8,-3,B3,787
B,Venezuela,3,1,2,4,-2,B4,787
C,United States,3,7,5,1,4,C1,787
C,Uruguay,3,5,4,1,3,C2,787
C,Bolivia,3,4,2,2,0,C3,787
C,Panama,3,0,1,8,-7,C4,787
D,Brazil,3,9,5,2,3,D1,787
D,Costa Rica,3,4,5,5,0,D2,787
D,Colombia,3,2,2,3,-1,D3,787
D,Paraguay,3,1,2,4,-2,D4,787
A,Argentina,3,7,6,2,4,A1,788
A,Chile,3,6,7,3,4,A2,788
A,Peru,3,2,2,3,-1,A3,788
A,Canada,3,1,2,9,-7,A4,788
B,Mexico,3,5,2,1,1,B1,788
B,Ecuador,3,4,2,2,0,B2,788
B,Venezuela,3,3,1,1,0,B3,788
B,Jamaica,3,2,1,2,-1,B4,788
C,United States,3,6,9,2,7,C1,788
C,Uruguay,3,5,1,0,1,C2,788
C,Panama,3,4,3,4,-1,C3,788
C,Bolivia,3,1,0,7,-7,C4,788
D,Paraguay,3,5,7,3,4,D1,788
D,Brazil,3,5,5,2,3,D2,788
D,Costa Rica,3,3,5,10,-5,D3,788
D,Colombia,3,2,4,6,-2,D4,788
A,Peru,3,7,5,3,2,A1,789
A,Argentina,3,6,9,2,7,A2,789
A,Canada,3,4,4,7,-3,A3,789
A,Chile,3,0,2,8,-6,A4,789
B,Mexico,3,7,7,2,5,B1,789
B,Ecuador,3,4,5,7,-2,B2,789
B,Jamaica,3,3,5,5,0,B3,789
B,Venezuela,3,1,3,6,-3,B4,789
C,United States,3,7,5,1,4,C1,789
C,Panama,3,4,3,3,0,C2,789
C,Bolivia,3,3,2,5,-3,C3,789
C,Uruguay,3,2,2,3,-1,C4,789
D,Brazil,3,7,6,3,3,D1,789
D,Costa Rica,3,4,5,6,-1,D2,789
D,Paraguay,3,3,3,3,0,D3,789
D,Colombia,3,1,6,8,-2,D4,789
A,Argentina,3,9,7,3,4,A1,790
A,Peru,3,4,4,3,1,A2,790
A,Canada,3,4,5,5,0,A3,790
A,Chile,3,0,0,5,-5,A4,790
B,Ecuador,3,9,6,1,5,B1,790
B,Venezuela,3,6,3,3,0,B2,790
B,Mexico,3,3,3,4,-1,B3,790
B,Jamaica,3,0,0,4,-4,B4,790
C,Uruguay,3,6,3,1,2,C1,790
C,Panama,3,6,2,5,-3,C2,790
C,United States,3,3,6,3,3,C3,790
C,Bolivia,3,3,2,4,-2,C4,790
D,Brazil,3,7,8,1,7,D1,790
D,Colombia,3,4,2,2,0,D2,790
D,Paraguay,3,4,4,6,-2,D3,790
D,Costa Rica,3,1,2,7,-5,D4,790
A,Argentina,3,9,11,3,8,A1,791
A,Peru,3,4,5,5,0,A2,791
A,Canada,3,3,3,8,-5,A3,791
A,Chile,3,1,3,6,-3,A4,791
B,Ecuador,3,7,7,3,4,B1,791
B,Jamaica,3,4,3,3,0,B2,791
B,Mexico,3,4,3,3,0,B3,791
B,Venezuela,3,1,3,7,-4,B4,791
C,Uruguay,3,7,7,4,3,C1,791
C,Panama,3,6,6,5,1,C2,791
C,United States,3,4,3,3,0,C3,791
C,Bolivia,3,0,2,6,-4,C4,791
D,Brazil,3,9,7,0,7,D1,791
D,Colombia,3,6,5,3,2,D2,791
D,Costa Rica,3,3,2,6,-4,D3,791
D,Paraguay,3,0,1,6,-5,D4,791
A,Argentina,3,9,9,0,9,A1,792
A,Peru,3,6,6,5,1,A2,792
A,Chile,3,3,3,6,-3,A3,792
A,Canada,3,0,1,8,-7,A4,792
B,Venezuela,3,7,8,1,7,B1,792
B,Ecuador,3,5,5,3,2,B2,792
B,Mexico,3,4,4,6,-2,B3,792
B,Jamaica,3,0,2,9,-7,B4,792
C,United States,3,6,7,3,4,C1,792
C,Uruguay,3,6,7,4,3,C2,792
C,Panama,3,3,5,7,-2,C3,792
C,Bolivia,3,3,3,8,-5,C4,792
D,Paraguay,3,5,3,2,1,D1,792
D,Brazil,3,5,2,1,1,D2,792
D,Costa Rica,3,5,2,1,1,D3,792
D,Colombia,3,0,2,5,-3,D4,792
A,Argentina,3,6,4,3,1,A1,793
A,Peru,3,4,5,3,2,A2,793
A,Canada,3,4,3,4,-1,A3,793
A,Chile,3,3,2,4,-2,A4,793
B,Mexico,3,9,7,1,6,B1,793
B,Ecuador,3,6,4,1,3,B2,793
B,Venezuela,3,3,2,6,-4,B3,793
B,Jamaica,3,0,2,7,-5,B4,793
C,Uruguay,3,9,11,4,7,C1,793
C,Panama,3,4,2,4,-2,C2,793
C,United States,3,3,3,3,0,C3,793
C,Bolivia,3,1,2,7,-5,C4,793
D,Colombia,3,7,7,0,7,D1,793
D,Brazil,3,5,4,1,3,D2,793
D,Paraguay,3,2,1,6,-5,D3,793
D,Costa Rica,3,1,0,5,-5,D4,793
A,Chile,3,5,4,2,2,A1,794
A,Argentina,3,5,2,1,1,A2,794
A,Peru,3,4,6,3,3,A3,794
A,Canada,3,1,1,7,-6,A4,794
B,Venezuela,3,6,6,3,3,B1,794
B,Ecuador,3,5,4,3,1,B2,794
B,Mexico,3,4,1,1,0,B3,794
B,Jamaica,3,1,1,5,-4,B4,794
C,Uruguay,3,7,4,2,2,C1,794
C,United States,3,6,3,2,1,C2,794
C,Bolivia,3,3,3,4,-1,C3,794
C,Panama,3,1,1,3,-2,C4,794
D,Colombia,3,9,7,0,7,D1,794
D,Brazil,3,6,6,4,2,D2,794
D,Costa Rica,3,3,3,6,-3,D3,794
D,Paraguay,3,0,0,6,-6,D4,794
A,Argentina,3,6,7,6,1,A1,795
A,Chile,3,4,5,4,1,A2,795
A,Canada,3,4,4,5,-1,A3,795
A,Peru,3,2,5,6,-1,A4,795
B,Venezuela,3,5,3,1,2,B1,795
B,Mexico,3,5,2,1,1,B2,795
B,Ecuador,3,3,2,2,0,B3,795
B,Jamaica,3,1,0,3,-3,B4,795
C,United States,3,7,6,4,2,C1,795
C,Uruguay,3,6,6,4,2,C2,795
C,Panama,3,3,2,4,-2,C3,795
C,Bolivia,3,1,2,4,-2,C4,795
D,Brazil,3,7,7,1,6,D1,795
D,Colombia,3,5,4,1,3,D2,795
D,Costa Rica,3,3,4,10,-6,D3,795
D,Paraguay,3,1,1,4,-3,D4,795
A,Argentina,3,7,9,4,5,A1,796
A,Chile,3,4,5,5,0,A2,796
A,Canada,3,4,4,4,0,A3,796
A,Peru,3,1,2,7,-5,A4,796
B,Mexico,3,7,4,0,4,B1,796
B,Venezuela,3,7,5,2,3,B2,796
B,Ecuador,3,3,5,8,-3,B3,796
B,Jamaica,3,0,1,5,-4,B4,796
C,Uruguay,3,6,6,4,2,C1,796
C,United States,3,4,10,5,5,C2,796
C,Panama,3,4,6,10,-4,C3,796
C,Bolivia,3,2,2,5,-3,C4,796
D,Colombia,3,7,4,2,2,D1,796
D,Costa Rica,3,4,4,7,-3,D2,796
D,Brazil,3,3,5,3,2,D3,796
D,Paraguay,3,3,3,4,-1,D4,796
A,Argentina,3,7,4,2,2,A1,797
A,Chile,3,5,5,3,2,A2,797
A,Canada,3,2,2,3,-1,A3,797
A,Peru,3,1,3,6,-3,A4,797
B,Venezuela,3,5,3,2,1,B1,797
B,Mexico,3,5,1,0,1,B2,797
B,Jamaica,3,3,2,3,-1,B3,797
B,Ecuador,3,2,1,2,-1,B4,797
C,Uruguay,3,6,4,3,1,C1,797
C,United States,3,5,5,2,3,C2,797
C,Panama,3,4,3,3,0,C3,797
C,Bolivia,3,1,1,5,-4,C4,797
D,Brazil,3,7,7,2,5,D1,797
D,Colombia,3,6,7,2,5,D2,797
D,Costa Rica,3,2,1,5,-4,D3,797
D,Paraguay,3,1,2,8,-6,D4,797
A,Argentina,3,7,5,2,3,A1,798
A,Peru,3,4,4,5,-1,A2,798
A,Canada,3,3,3,4,-1,A3,798
A,Chile,3,3,3,4,-1,A4,798
B,Mexico,3,7,5,2,3,B1,798
B,Ecuador,3,4,2,3,-1,B2,798
B,Jamaica,3,3,4,4,0,B3,798
B,Venezuela,3,1,1,3,-2,B4,798
C,Uruguay,3,7,4,0,4,C1,798
C,United States,3,6,8,1,7,C2,798
C,Bolivia,3,2,1,6,-5,C3,798
C,Panama,3,1,1,7,-6,C4,798
D,Brazil,3,7,3,1,2,D1,798
D,Paraguay,3,5,3,0,3,D2,798
D,Colombia,3,4,3,2,1,D3,798
D,Costa Rica,3,0,0,6,-6,D4,798
A,Argentina,3,7,5,2,3,A1,799
A,Chile,3,5,1,0,1,A2,799
A,Peru,3,2,2,4,-2,A3,799
A,Canada,3,1,4,6,-2,A4,799
B,Venezuela,3,7,6,3,3,B1,799
B,Ecuador,3,6,3,3,0,B2,799
B,Jamaica,3,3,4,4,0,B3,799
B,Mexico,3,1,2,5,-3,B4,799
C,Uruguay,3,9,6,1,5,C1,799
C,United States,3,4,5,5,0,C2,799
C,Panama,3,2,2,4,-2,C3,799
C,Bolivia,3,1,4,7,-3,C4,799
D,Brazil,3,9,7,3,4,D1,799
D,Colombia,3,6,7,2,5,D2,799
D,Paraguay,3,3,2,2,0,D3,799
D,Costa Rica,3,0,2,11,-9,D4,799
A,Argentina,3,6,5,2,3,A1,800
A,Peru,3,4,3,3,0,A2,800
A,Canada,3,4,1,1,0,A3,800
A,Chile,3,3,2,5,-3,A4,800
B,Mexico,3,7,7,2,5,B1,800
B,Ecuador,3,6,5,2,3,B2,800
B,Venezuela,3,4,5,5,0,B3,800
B,Jamaica,3,0,1,9,-8,B4,800
C,Uruguay,3,9,10,3,7,C1,800
C,United States,3,6,4,3,1,C2,800
C,Bolivia,3,1,2,4,-2,C3,800
C,Panama,3,1,2,8,-6,C4,800
D,Colombia,3,9,5,0,5,D1,800
D,Paraguay,3,4,3,2,1,D2,800
D,Brazil,3,4,3,3,0,D3,800
D,Costa Rica,3,0,0,6,-6,D4,800
A,Argentina,3,9,4,0,4,A1,801
A,Chile,3,6,4,1,3,A2,801
A,Canada,3,3,4,6,-2,A3,801
A,Peru,3,0,2,7,-5,A4,801
B,Ecuador,3,9,9,1,8,B1,801
B,Mexico,3,4,2,4,-2,B2,801
B,Venezuela,3,4,2,4,-2,B3,801
B,Jamaica,3,0,0,4,-4,B4,801
C,Uruguay,3,9,10,1,9,C1,801
C,United States,3,6,4,3,1,C2,801
C,Panama,3,3,1,5,-4,C3,801
C,Bolivia,3,0,0,6,-6,C4,801
D,Brazil,3,7,7,2,5,D1,801
D,Paraguay,3,7,3,1,2,D2,801
D,Colombia,3,3,4,6,-2,D3,801
D,Costa Rica,3,0,2,7,-5,D4,801
A,Peru,3,5,3,1,2,A1,802
A,Argentina,3,5,2,1,1,A2,802
A,Canada,3,3,1,3,-2,A3,802
A,Chile,3,2,2,3,-1,A4,802
B,Venezuela,3,7,6,3,3,B1,802
B,Ecuador,3,5,4,3,1,B2,802
B,Mexico,3,4,4,4,0,B3,802
B,Jamaica,3,0,1,5,-4,B4,802
C,Bolivia,3,6,5,3,2,C1,802
C,Uruguay,3,6,5,4,1,C2,802
C,United States,3,4,3,3,0,C3,802
C,Panama,3,1,1,4,-3,C4,802
D,Brazil,3,7,8,0,8,D1,802
D,Colombia,3,7,5,2,3,D2,802
D,Paraguay,3,3,1,2,-1,D3,802
D,Costa Rica,3,0,2,12,-10,D4,802
A,Chile,3,7,5,3,2,A1,803
A,Peru,3,4,5,4,1,A2,803
A,Canada,3,2,3,4,-1,A3,803
A,Argentina,3,2,1,3,-2,A4,803
B,Ecuador,3,7,4,1,3,B1,803
B,Mexico,3,4,3,3,0,B2,803
B,Venezuela,3,4,3,3,0,B3,803
B,Jamaica,3,1,1,4,-3,B4,803
C,United States,3,6,10,5,5,C1,803
C,Uruguay,3,5,5,3,2,C2,803
C,Panama,3,4,4,5,-1,C3,803
C,Bolivia,3,1,3,9,-6,C4,803
D,Brazil,3,9,8,2,6,D1,803
D,Colombia,3,6,4,2,2,D2,803
D,Costa Rica,3,1,0,3,-3,D3,803
D,Paraguay,3,1,1,6,-5,D4,803
A,Argentina,3,4,5,4,1,A1,804
A,Peru,3,4,4,4,0,A2,804
A,Canada,3,4,2,2,0,A3,804
A,Chile,3,4,2,3,-1,A4,804
B,Ecuador,3,7,7,3,4,B1,804
B,Mexico,3,4,3,3,0,B2,804
B,Jamaica,3,2,4,6,-2,B3,804
B,Venezuela,3,2,4,6,-2,B4,804
C,United States,3,9,7,1,6,C1,804
C,Uruguay,3,4,4,2,2,C2,804
C,Panama,3,3,4,7,-3,C3,804
C,Bolivia,3,1,3,8,-5,C4,804
D,Brazil,3,7,5,2,3,D1,804
D,Colombia,3,6,4,3,1,D2,804
D,Paraguay,3,3,2,2,0,D3,804
D,Costa Rica,3,1,3,7,-4,D4,804
A,Argentina,3,9,7,1,6,A1,805
A,Peru,3,4,4,3,1,A2,805
A,Canada,3,2,4,5,-1,A3,805
A,Chile,3,1,1,7,-6,A4,805
B,Mexico,3,6,5,1,4,B1,805
B,Venezuela,3,5,1,0,1,B2,805
B,Ecuador,3,2,1,3,-2,B3,805
B,Jamaica,3,2,1,4,-3,B4,805
C,United States,3,9,11,4,7,C1,805
C,Panama,3,4,5,7,-2,C2,805
C,Bolivia,3,2,4,7,-3,C3,805
C,Uruguay,3,1,2,4,-2,C4,805
D,Paraguay,3,6,4,4,0,D1,805
D,Brazil,3,5,4,1,3,D2,805
D,Colombia,3,4,2,2,0,D3,805
D,Costa Rica,3,1,1,4,-3,D4,805
A,Argentina,3,9,13,5,8,A1,806
A,Chile,3,6,4,2,2,A2,806
A,Peru,3,1,3,5,-2,A3,806
A,Canada,3,1,1,9,-8,A4,806
B,Mexico,3,6,3,3,0,B1,806
B,Ecuador,3,4,4,3,1,B2,806
B,Jamaica,3,4,1,1,0,B3,806
B,Venezuela,3,3,5,6,-1,B4,806
C,Uruguay,3,5,6,4,2,C1,806
C,United States,3,4,5,5,0,C2,806
C,Bolivia,3,4,5,6,-1,C3,806
C,Panama,3,2,2,3,-1,C4,806
D,Brazil,3,9,8,0,8,D1,806
D,Costa Rica,3,4,3,3,0,D2,806
D,Colombia,3,4,1,2,-1,D3,806
D,Paraguay,3,0,0,7,-7,D4,806
A,Argentina,3,7,4,0,4,A1,807
A,Chile,3,6,4,2,2,A2,807
A,Peru,3,2,1,3,-2,A3,807
A,Canada,3,1,1,5,-4,A4,807
B,Ecuador,3,6,5,3,2,B1,807
B,Jamaica,3,6,4,3,1,B2,807
B,Venezuela,3,3,4,5,-1,B3,807
B,Mexico,3,3,4,6,-2,B4,807
C,Uruguay,3,9,6,1,5,C1,807
C,United States,3,4,1,1,0,C2,807
C,Bolivia,3,3,2,4,-2,C3,807
C,Panama,3,1,2,5,-3,C4,807
D,Brazil,3,7,5,0,5,D1,807
D,Colombia,3,7,5,0,5,D2,807
D,Costa Rica,3,3,1,7,-6,D3,807
D,Paraguay,3,0,0,4,-4,D4,807
A,Peru,3,6,3,2,1,A1,808
A,Argentina,3,4,5,5,0,A2,808
A,Canada,3,4,3,3,0,A3,808
A,Chile,3,3,4,5,-1,A4,808
B,Ecuador,3,7,5,2,3,B1,808
B,Mexico,3,5,7,4,3,B2,808
B,Venezuela,3,2,5,7,-2,B3,808
B,Jamaica,3,1,1,5,-4,B4,808
C,Panama,3,6,6,4,2,C1,808
C,Uruguay,3,4,2,2,0,C2,808
C,Bolivia,3,4,2,3,-1,C3,808
C,United States,3,3,4,5,-1,C4,808
D,Brazil,3,9,13,1,12,D1,808
D,Colombia,3,6,6,2,4,D2,808
D,Paraguay,3,3,3,9,-6,D3,808
D,Costa Rica,3,0,0,10,-10,D4,808
A,Argentina,3,6,4,1,3,A1,809
A,Peru,3,6,2,1,1,A2,809
A,Chile,3,4,1,1,0,A3,809
A,Canada,3,1,0,4,-4,A4,809
B,Ecuador,3,7,3,0,3,B1,809
B,Jamaica,3,4,3,3,0,B2,809
B,Venezuela,3,3,4,5,-1,B3,809
B,Mexico,3,3,2,4,-2,B4,809
C,United States,3,6,7,4,3,C1,809
C,Uruguay,3,6,4,3,1,C2,809
C,Panama,3,3,5,5,0,C3,809
C,Bolivia,3,3,2,6,-4,C4,809
D,Brazil,3,6,5,3,2,D1,809
D,Colombia,3,6,4,3,1,D2,809
D,Paraguay,3,4,3,3,0,D3,809
D,Costa Rica,3,1,1,4,-3,D4,809
A,Peru,3,5,4,2,2,A1,810
A,Argentina,3,4,6,4,2,A2,810
A,Canada,3,4,3,5,-2,A3,810
A,Chile,3,2,3,5,-2,A4,810
B,Ecuador,3,6,6,3,3,B1,810
B,Venezuela,3,4,3,3,0,B2,810
B,Mexico,3,4,1,1,0,B3,810
B,Jamaica,3,3,2,5,-3,B4,810
C,Uruguay,3,7,7,2,5,C1,810
C,United States,3,6,4,2,2,C2,810
C,Panama,3,4,4,5,-1,C3,810
C,Bolivia,3,0,1,7,-6,C4,810
D,Brazil,3,7,9,2,7,D1,810
D,Paraguay,3,6,3,3,0,D2,810
D,Colombia,3,2,3,4,-1,D3,810
D,Costa Rica,3,1,2,8,-6,D4,810
A,Argentina,3,9,9,3,6,A1,811
A,Chile,3,4,2,1,1,A2,811
A,Canada,3,2,1,4,-3,A3,811
A,Peru,3,1,2,6,-4,A4,811
B,Ecuador,3,7,6,2,4,B1,811
B,Venezuela,3,4,2,3,-1,B2,811
B,Mexico,3,3,4,4,0,B3,811
B,Jamaica,3,1,1,4,-3,B4,811
C,Uruguay,3,7,7,2,5,C1,811
C,Panama,3,6,3,2,1,C2,811
C,United States,3,4,3,3,0,C3,811
C,Bolivia,3,0,0,6,-6,C4,811
D,Brazil,3,7,4,1,3,D1,811
D,Paraguay,3,5,8,3,5,D2,811
D,Colombia,3,4,4,3,1,D3,811
D,Costa Rica,3,0,0,9,-9,D4,811
A,Peru,3,7,3,0,3,A1,812
A,Argentina,3,7,2,0,2,A2,812
A,Chile,3,3,2,3,-1,A3,812
A,Canada,3,0,1,5,-4,A4,812
B,Mexico,3,9,5,0,5,B1,812
B,Ecuador,3,4,3,3,0,B2,812
B,Venezuela,3,3,3,5,-2,B3,812
B,Jamaica,3,1,1,4,-3,B4,812
C,United States,3,9,7,1,6,C1,812
C,Uruguay,3,6,4,5,-1,C2,812
C,Panama,3,1,2,4,-2,C3,812
C,Bolivia,3,1,2,5,-3,C4,812
D,Paraguay,3,6,5,3,2,D1,812
D,Colombia,3,6,3,2,1,D2,812
D,Brazil,3,3,6,4,2,D3,812
D,Costa Rica,3,3,3,8,-5,D4,812
A,Argentina,3,9,5,0,5,A1,813
A,Chile,3,4,4,3,1,A2,813
A,Peru,3,4,3,4,-1,A3,813
A,Canada,3,0,2,7,-5,A4,813
B,Ecuador,3,6,8,4,4,B1,813
B,Mexico,3,6,6,3,3,B2,813
B,Venezuela,3,3,4,7,-3,B3,813
B,Jamaica,3,3,2,6,-4,B4,813
C,Bolivia,3,9,7,2,5,C1,813
C,Uruguay,3,6,6,4,2,C2,813
C,United States,3,1,1,4,-3,C3,813
C,Panama,3,1,1,5,-4,C4,813
D,Colombia,3,6,12,5,7,D1,813
D,Brazil,3,6,6,5,1,D2,813
D,Costa Rica,3,3,4,7,-3,D3,813
D,Paraguay,3,3,4,9,-5,D4,813
A,Canada,3,5,5,2,3,A1,814
A,Argentina,3,5,5,3,2,A2,814
A,Peru,3,3,5,5,0,A3,814
A,Chile,3,1,4,9,-5,A4,814
B,Mexico,3,5,5,3,2,B1,814
B,Jamaica,3,4,3,4,-1,B2,814
B,Ecuador,3,3,4,4,0,B3,814
B,Venezuela,3,2,3,4,-1,B4,814
C,United States,3,6,8,5,3,C1,814
C,Uruguay,3,6,4,3,1,C2,814
C,Panama,3,3,4,6,-2,C3,814
C,Bolivia,3,3,3,5,-2,C4,814
D,Brazil,3,5,4,3,1,D1,814
D,Colombia,3,4,4,3,1,D2,814
D,Paraguay,3,4,3,3,0,D3,814
D,Costa Rica,3,2,4,6,-2,D4,814
A,Argentina,3,5,5,4,1,A1,815
A,Canada,3,4,4,3,1,A2,815
A,Peru,3,4,2,3,-1,A3,815
A,Chile,3,2,1,2,-1,A4,815
B,Mexico,3,7,9,2,7,B1,815
B,Ecuador,3,6,3,5,-2,B2,815
B,Jamaica,3,2,2,4,-2,B3,815
B,Venezuela,3,1,0,3,-3,B4,815
C,United States,3,6,9,3,6,C1,815
C,Panama,3,6,5,3,2,C2,815
C,Uruguay,3,6,8,8,0,C3,815
C,Bolivia,3,0,2,10,-8,C4,815
D,Colombia,3,7,3,0,3,D1,815
D,Brazil,3,5,2,1,1,D2,815
D,Paraguay,3,3,1,3,-2,D3,815
D,Costa Rica,3,1,1,3,-2,D4,815
A,Argentina,3,9,9,2,7,A1,816
A,Peru,3,6,7,4,3,A2,816
A,Chile,3,1,3,5,-2,A3,816
A,Canada,3,1,2,10,-8,A4,816
B,Mexico,3,7,8,4,4,B1,816
B,Ecuador,3,7,6,3,3,B2,816
B,Venezuela,3,3,5,8,-3,B3,816
B,Jamaica,3,0,3,7,-4,B4,816
C,United States,3,7,5,1,4,C1,816
C,Bolivia,3,5,6,2,4,C2,816
C,Uruguay,3,4,2,2,0,C3,816
C,Panama,3,0,1,9,-8,C4,816
D,Brazil,3,7,9,2,7,D1,816
D,Colombia,3,6,5,5,0,D2,816
D,Paraguay,3,4,5,5,0,D3,816
D,Costa Rica,3,0,1,8,-7,D4,816
A,Argentina,3,6,6,2,4,A1,817
A,Canada,3,6,5,4,1,A2,817
A,Chile,3,4,2,3,-1,A3,817
A,Peru,3,1,0,4,-4,A4,817
B,Jamaica,3,7,6,1,5,B1,817
B,Ecuador,3,7,4,1,3,B2,817
B,Mexico,3,3,3,4,-1,B3,817
B,Venezuela,3,0,0,7,-7,B4,817
C,Uruguay,3,9,8,0,8,C1,817
C,United States,3,6,3,3,0,C2,817
C,Panama,3,3,3,6,-3,C3,817
C,Bolivia,3,0,0,5,-5,C4,817
D,Brazil,3,9,6,0,6,D1,817
D,Colombia,3,4,2,3,-1,D2,817
D,Paraguay,3,3,4,2,2,D3,817
D,Costa Rica,3,1,1,8,-7,D4,817
A,Argentina,3,5,3,2,1,A1,818
A,Peru,3,4,5,5,0,A2,818
A,Canada,3,3,3,3,0,A3,818
A,Chile,3,2,1,2,-1,A4,818
B,Mexico,3,7,7,1,6,B1,818
B,Jamaica,3,4,3,3,0,B2,818
B,Venezuela,3,3,3,8,-5,B3,818
B,Ecuador,3,2,3,4,-1,B4,818
C,Uruguay,3,7,8,2,6,C1,818
C,United States,3,4,5,5,0,C2,818
C,Panama,3,3,3,8,-5,C3,818
C,Bolivia,3,2,3,4,-1,C4,818
D,Brazil,3,6,5,2,3,D1,818
D,Costa Rica,3,4,3,2,1,D2,818
D,Colombia,3,4,4,4,0,D3,818
D,Paraguay,3,3,2,6,-4,D4,818
A,Chile,3,5,4,3,1,A1,819
A,Argentina,3,4,2,1,1,A2,819
A,Peru,3,3,2,2,0,A3,819
A,Canada,3,2,3,5,-2,A4,819
B,Ecuador,3,9,9,1,8,B1,819
B,Mexico,3,6,5,3,2,B2,819
B,Venezuela,3,3,2,4,-2,B3,819
B,Jamaica,3,0,0,8,-8,B4,819
C,United States,3,7,4,1,3,C1,819
C,Panama,3,5,5,4,1,C2,819
C,Uruguay,3,2,3,5,-2,C3,819
C,Bolivia,3,1,2,4,-2,C4,819
D,Brazil,3,7,6,0,6,D1,819
D,Colombia,3,4,2,2,0,D2,819
D,Costa Rica,3,4,2,6,-4,D3,819
D,Paraguay,3,1,0,2,-2,D4,819
A,Argentina,3,9,9,4,5,A1,820
A,Chile,3,6,8,5,3,A2,820
A,Peru,3,3,1,5,-4,A3,820
A,Canada,3,0,1,5,-4,A4,820
B,Mexico,3,7,6,2,4,B1,820
B,Jamaica,3,3,5,5,0,B2,820
B,Ecuador,3,2,4,6,-2,B3,820
B,Venezuela,3,2,3,5,-2,B4,820
C,United States,3,7,6,2,4,C1,820
C,Uruguay,3,4,2,2,0,C2,820
C,Bolivia,3,3,3,4,-1,C3,820
C,Panama,3,3,2,5,-3,C4,820
D,Brazil,3,9,10,0,10,D1,820
D,Colombia,3,6,3,2,1,D2,820
D,Costa Rica,3,3,2,8,-6,D3,820
D,Paraguay,3,0,0,5,-5,D4,820
A,Canada,3,9,4,1,3,A1,821
A,Argentina,3,4,3,2,1,A2,821
A,Peru,3,3,1,3,-2,A3,821
A,Chile,3,1,0,2,-2,A4,821
B,Ecuador,3,7,4,1,3,B1,821
B,Mexico,3,4,3,4,-1,B2,821
B,Jamaica,3,3,1,1,0,B3,821
B,Venezuela,3,1,2,4,-2,B4,821
C,Bolivia,3,7,6,4,2,C1,821
C,Uruguay,3,5,6,4,2,C2,821
C,Panama,3,3,4,5,-1,C3,821
C,United States,3,1,2,5,-3,C4,821
D,Colombia,3,9,6,0,6,D1,821
D,Brazil,3,6,6,4,2,D2,821
D,Costa Rica,3,1,1,4,-3,D3,821
D,Paraguay,3,1,0,5,-5,D4,821
A,Argentina,3,7,6,2,4,A1,822
A,Chile,3,5,3,1,2,A2,822
A,Peru,3,2,2,3,-1,A3,822
A,Canada,3,1,1,6,-5,A4,822
B,Ecuador,3,6,5,3,2,B1,822
B,Mexico,3,5,5,2,3,B2,822
B,Venezuela,3,4,5,3,2,B3,822
B,Jamaica,3,1,1,8,-7,B4,822
C,Uruguay,3,7,8,1,7,C1,822
C,United States,3,4,5,3,2,C2,822
C,Panama,3,4,3,5,-2,C3,822
C,Bolivia,3,1,3,10,-7,C4,822
D,Brazil,3,7,5,3,2,D1,822
D,Colombia,3,6,6,2,4,D2,822
D,Costa Rica,3,3,3,6,-3,D3,822
D,Paraguay,3,1,2,5,-3,D4,822
A,Argentina,3,9,7,2,5,A1,823
A,Canada,3,2,3,4,-1,A2,823
A,Chile,3,2,3,5,-2,A3,823
A,Peru,3,2,0,2,-2,A4,823
B,Mexico,3,9,7,0,7,B1,823
B,Ecuador,3,4,3,3,0,B2,823
B,Jamaica,3,4,3,3,0,B3,823
B,Venezuela,3,0,1,8,-7,B4,823
C,United States,3,7,9,2,7,C1,823
C,Uruguay,3,6,7,4,3,C2,823
C,Panama,3,2,4,5,-1,C3,823
C,Bolivia,3,1,3,12,-9,C4,823
D,Brazil,3,9,5,2,3,D1,823
D,Costa Rica,3,6,5,3,2,D2,823
D,Colombia,3,3,2,3,-1,D3,823
D,Paraguay,3,0,3,7,-4,D4,823
A,Argentina,3,9,3,0,3,A1,824
A,Chile,3,3,4,4,0,A2,824
A,Canada,3,3,3,4,-1,A3,824
A,Peru,3,3,3,5,-2,A4,824
B,Jamaica,3,6,3,2,1,B1,824
B,Venezuela,3,4,3,2,1,B2,824
B,Mexico,3,4,2,2,0,B3,824
B,Ecuador,3,2,0,2,-2,B4,824
C,United States,3,6,3,2,1,C1,824
C,Panama,3,4,4,3,1,C2,824
C,Uruguay,3,4,3,3,0,C3,824
C,Bolivia,3,2,2,4,-2,C4,824
D,Colombia,3,9,5,1,4,D1,824
D,Paraguay,3,4,3,2,1,D2,824
D,Brazil,3,4,2,2,0,D3,824
D,Costa Rica,3,0,1,6,-5,D4,824
A,Argentina,3,9,4,1,3,A1,825
A,Canada,3,6,5,1,4,A2,825
A,Chile,3,3,2,4,-2,A3,825
A,Peru,3,0,0,5,-5,A4,825
B,Ecuador,3,9,8,2,6,B1,825
B,Mexico,3,4,3,4,-1,B2,825
B,Venezuela,3,3,2,3,-1,B3,825
B,Jamaica,3,1,1,5,-4,B4,825
C,United States,3,9,6,2,4,C1,825
C,Panama,3,4,4,4,0,C2,825
C,Uruguay,3,4,4,4,0,C3,825
C,Bolivia,3,0,3,7,-4,C4,825
D,Brazil,3,7,6,1,5,D1,825
D,Colombia,3,4,2,3,-1,D2,825
D,Paraguay,3,3,3,5,-2,D3,825
D,Costa Rica,3,2,3,5,-2,D4,825
A,Argentina,3,7,5,2,3,A1,826
A,Chile,3,4,3,1,2,A2,826
A,Peru,3,2,1,3,-2,A3,826
A,Canada,3,2,1,4,-3,A4,826
B,Ecuador,3,7,4,1,3,B1,826
B,Mexico,3,5,2,1,1,B2,826
B,Venezuela,3,4,2,1,1,B3,826
B,Jamaica,3,0,0,5,-5,B4,826
C,Uruguay,3,9,10,2,8,C1,826
C,United States,3,6,8,2,6,C2,826
C,Bolivia,3,3,2,8,-6,C3,826
C,Panama,3,0,0,8,-8,C4,826
D,Brazil,3,9,8,4,4,D1,826
D,Paraguay,3,4,7,7,0,D2,826
D,Colombia,3,3,4,5,-1,D3,826
D,Costa Rica,3,1,6,9,-3,D4,826
A,Canada,3,5,5,3,2,A1,827
A,Argentina,3,5,2,1,1,A2,827
A,Peru,3,4,2,3,-1,A3,827
A,Chile,3,1,1,3,-2,A4,827
B,Venezuela,3,7,6,4,2,B1,827
B,Mexico,3,5,6,3,3,B2,827
B,Jamaica,3,2,3,4,-1,B3,827
B,Ecuador,3,1,2,6,-4,B4,827
C,United States,3,9,6,1,5,C1,827
C,Panama,3,6,4,4,0,C2,827
C,Uruguay,3,1,1,3,-2,C3,827
C,Bolivia,3,1,1,4,-3,C4,827
D,Brazil,3,9,11,1,10,D1,827
D,Costa Rica,3,4,4,9,-5,D2,827
D,Colombia,3,2,4,5,-1,D3,827
D,Paraguay,3,1,0,4,-4,D4,827
A,Argentina,3,7,9,2,7,A1,828
A,Peru,3,4,5,5,0,A2,828
A,Chile,3,3,3,3,0,A3,828
A,Canada,3,1,1,8,-7,A4,828
B,Ecuador,3,7,8,2,6,B1,828
B,Mexico,3,5,5,3,2,B2,828
B,Jamaica,3,3,6,9,-3,B3,828
B,Venezuela,3,1,2,7,-5,B4,828
C,Uruguay,3,9,7,2,5,C1,828
C,Bolivia,3,6,4,4,0,C2,828
C,Panama,3,3,2,3,-1,C3,828
C,United States,3,0,1,5,-4,C4,828
D,Brazil,3,6,5,2,3,D1,828
D,Colombia,3,5,6,5,1,D2,828
D,Costa Rica,3,2,4,6,-2,D3,828
D,Paraguay,3,2,4,6,-2,D4,828
A,Argentina,3,6,4,1,3,A1,829
A,Chile,3,4,1,2,-1,A2,829
A,Peru,3,4,1,2,-1,A3,829
A,Canada,3,3,2,3,-1,A4,829
B,Ecuador,3,6,6,1,5,B1,829
B,Venezuela,3,6,4,2,2,B2,829
B,Mexico,3,3,1,4,-3,B3,829
B,Jamaica,3,3,2,6,-4,B4,829
C,United States,3,7,7,1,6,C1,829
C,Uruguay,3,5,5,4,1,C2,829
C,Bolivia,3,4,4,6,-2,C3,829
C,Panama,3,0,0,5,-5,C4,829
D,Brazil,3,5,2,1,1,D1,829
D,Paraguay,3,4,4,3,1,D2,829
D,Colombia,3,4,2,3,-1,D3,829
D,Costa Rica,3,3,2,3,-1,D4,829
A,Argentina,3,5,4,2,2,A1,830
A,Chile,3,5,4,2,2,A2,830
A,Canada,3,4,3,4,-1,A3,830
A,Peru,3,1,0,3,-3,A4,830
B,Mexico,3,7,6,1,5,B1,830
B,Ecuador,3,7,6,2,4,B2,830
B,Venezuela,3,1,1,5,-4,B3,830
B,Jamaica,3,1,2,7,-5,B4,830
C,Uruguay,3,7,6,1,5,C1,830
C,United States,3,5,5,4,1,C2,830
C,Panama,3,4,5,4,1,C3,830
C,Bolivia,3,0,1,8,-7,C4,830
D,Colombia,3,7,6,0,6,D1,830
D,Brazil,3,7,5,1,4,D2,830
D,Paraguay,3,3,2,7,-5,D3,830
D,Costa Rica,3,0,2,7,-5,D4,830
A,Argentina,3,6,9,4,5,A1,831
A,Chile,3,5,5,4,1,A2,831
A,Canada,3,4,3,2,1,A3,831
A,Peru,3,1,0,7,-7,A4,831
B,Ecuador,3,9,5,0,5,B1,831
B,Venezuela,3,4,3,4,-1,B2,831
B,Mexico,3,3,3,3,0,B3,831
B,Jamaica,3,1,1,5,-4,B4,831
C,Uruguay,3,9,9,0,9,C1,831
C,Panama,3,6,6,2,4,C2,831
C,United States,3,3,3,7,-4,C3,831
C,Bolivia,3,0,1,10,-9,C4,831
D,Brazil,3,7,5,2,3,D1,831
D,Colombia,3,4,5,2,3,D2,831
D,Paraguay,3,3,1,1,0,D3,831
D,Costa Rica,3,1,0,6,-6,D4,831
A,Argentina,3,5,3,1,2,A1,832
A,Peru,3,5,2,1,1,A2,832
A,Chile,3,3,1,1,0,A3,832
A,Canada,3,1,1,4,-3,A4,832
B,Mexico,3,9,7,2,5,B1,832
B,Jamaica,3,3,4,5,-1,B2,832
B,Venezuela,3,3,2,3,-1,B3,832
B,Ecuador,3,3,3,6,-3,B4,832
C,Uruguay,3,7,6,2,4,C1,832
C,Panama,3,5,2,1,1,C2,832
C,Bolivia,3,3,2,5,-3,C3,832
C,United States,3,1,2,4,-2,C4,832
D,Brazil,3,7,7,2,5,D1,832
D,Paraguay,3,5,2,1,1,D2,832
D,Colombia,3,4,3,5,-2,D3,832
D,Costa Rica,3,0,2,6,-4,D4,832
A,Argentina,3,7,3,1,2,A1,833
A,Peru,3,6,2,1,1,A2,833
A,Chile,3,4,1,1,0,A3,833
A,Canada,3,0,1,4,-3,A4,833
B,Venezuela,3,7,2,0,2,B1,833
B,Ecuador,3,6,6,2,4,B2,833
B,Mexico,3,2,1,3,-2,B3,833
B,Jamaica,3,1,0,4,-4,B4,833
C,United States,3,9,5,1,4,C1,833
C,Uruguay,3,4,5,5,0,C2,833
C,Panama,3,2,5,7,-2,C3,833
C,Bolivia,3,1,2,4,-2,C4,833
D,Brazil,3,9,8,2,6,D1,833
D,Paraguay,3,4,3,3,0,D2,833
D,Costa Rica,3,2,3,6,-3,D3,833
D,Colombia,3,1,2,5,-3,D4,833
A,Argentina,3,5,5,3,2,A1,834
A,Peru,3,4,4,3,1,A2,834
A,Canada,3,4,2,4,-2,A3,834
A,Chile,3,2,3,4,-1,A4,834
B,Mexico,3,7,7,2,5,B1,834
B,Venezuela,3,4,3,4,-1,B2,834
B,Ecuador,3,3,4,6,-2,B3,834
B,Jamaica,3,3,4,6,-2,B4,834
C,United States,3,7,8,2,6,C1,834
C,Bolivia,3,4,5,3,2,C2,834
C,Uruguay,3,3,2,4,-2,C3,834
C,Panama,3,3,2,8,-6,C4,834
D,Paraguay,3,5,2,0,2,D1,834
D,Brazil,3,5,1,0,1,D2,834
D,Colombia,3,3,2,2,0,D3,834
D,Costa Rica,3,1,2,5,-3,D4,834
A,Argentina,3,7,8,3,5,A1,835
A,Chile,3,6,8,6,2,A2,835
A,Peru,3,4,3,3,0,A3,835
A,Canada,3,0,1,8,-7,A4,835
B,Mexico,3,9,11,2,9,B1,835
B,Venezuela,3,4,4,5,-1,B2,835
B,Ecuador,3,4,3,6,-3,B3,835
B,Jamaica,3,0,0,5,-5,B4,835
C,United States,3,7,8,0,8,C1,835
C,Uruguay,3,5,5,3,2,C2,835
C,Panama,3,4,3,4,-1,C3,835
C,Bolivia,3,0,2,11,-9,C4,835
D,Paraguay,3,6,5,3,2,D1,835
D,Brazil,3,6,3,3,0,D2,835
D,Colombia,3,3,3,4,-1,D3,835
D,Costa Rica,3,3,2,3,-1,D4,835
A,Argentina,3,7,3,1,2,A1,836
A,Chile,3,4,7,4,3,A2,836
A,Canada,3,3,5,5,0,A3,836
A,Peru,3,1,3,8,-5,A4,836
B,Mexico,3,5,5,3,2,B1,836
B,Ecuador,3,4,3,3,0,B2,836
B,Venezuela,3,4,2,3,-1,B3,836
B,Jamaica,3,3,3,4,-1,B4,836
C,United States,3,6,6,2,4,C1,836
C,Uruguay,3,6,5,2,3,C2,836
C,Panama,3,4,3,5,-2,C3,836
C,Bolivia,3,1,2,7,-5,C4,836
D,Brazil,3,9,5,1,4,D1,836
D,Colombia,3,4,4,2,2,D2,836
D,Paraguay,3,3,2,5,-3,D3,836
D,Costa Rica,3,1,3,6,-3,D4,836
A,Argentina,3,7,8,3,5,A1,837
A,Peru,3,7,5,2,3,A2,837
A,Chile,3,3,3,6,-3,A3,837
A,Canada,3,0,1,6,-5,A4,837
B,Mexico,3,9,6,2,4,B1,837
B,Venezuela,3,4,3,3,0,B2,837
B,Ecuador,3,3,4,3,1,B3,837
B,Jamaica,3,1,1,6,-5,B4,837
C,Panama,3,9,3,0,3,C1,837
C,Uruguay,3,3,6,5,1,C2,837
C,United States,3,3,5,5,0,C3,837
C,Bolivia,3,3,4,8,-4,C4,837
D,Colombia,3,7,3,0,3,D1,837
D,Brazil,3,6,7,1,6,D2,837
D,Costa Rica,3,3,1,7,-6,D3,837
D,Paraguay,3,1,0,3,-3,D4,837
A,Argentina,3,9,10,1,9,A1,838
A,Peru,3,4,5,5,0,A2,838
A,Chile,3,2,2,7,-5,A3,838
A,Canada,3,1,4,8,-4,A4,838
B,Mexico,3,6,7,3,4,B1,838
B,Venezuela,3,6,4,5,-1,B2,838
B,Jamaica,3,4,6,7,-1,B3,838
B,Ecuador,3,1,3,5,-2,B4,838
C,Uruguay,3,6,5,4,1,C1,838
C,United States,3,5,4,1,3,C2,838
C,Panama,3,4,2,4,-2,C3,838
C,Bolivia,3,1,3,5,-2,C4,838
D,Colombia,3,7,5,2,3,D1,838
D,Costa Rica,3,4,3,3,0,D2,838
D,Brazil,3,3,4,4,0,D3,838
D,Paraguay,3,1,0,3,-3,D4,838
A,Argentina,3,7,6,1,5,A1,839
A,Canada,3,4,2,2,0,A2,839
A,Peru,3,3,1,3,-2,A3,839
A,Chile,3,3,3,6,-3,A4,839
B,Mexico,3,9,6,1,5,B1,839
B,Venezuela,3,4,4,2,2,B2,839
B,Jamaica,3,4,5,5,0,B3,839
B,Ecuador,3,0,0,7,-7,B4,839
C,Uruguay,3,9,9,1,8,C1,839
C,United States,3,6,4,4,0,C2,839
C,Panama,3,1,1,4,-3,C3,839
C,Bolivia,3,1,2,7,-5,C4,839
D,Paraguay,3,6,2,2,0,D1,839
D,Brazil,3,4,3,2,1,D2,839
D,Costa Rica,3,4,3,2,1,D3,839
D,Colombia,3,3,1,3,-2,D4,839
A,Peru,3,9,6,1,5,A1,840
A,Chile,3,6,9,4,5,A2,840
A,Argentina,3,3,3,5,-2,A3,840
A,Canada,3,0,1,9,-8,A4,840
B,Venezuela,3,7,3,0,3,B1,840
B,Jamaica,3,4,3,4,-1,B2,840
B,Mexico,3,3,2,2,0,B3,840
B,Ecuador,3,1,2,4,-2,B4,840
C,Uruguay,3,5,5,3,2,C1,840
C,United States,3,4,4,4,0,C2,840
C,Bolivia,3,4,4,7,-3,C3,840
C,Panama,3,3,7,6,1,C4,840
D,Brazil,3,7,4,1,3,D1,840
D,Colombia,3,7,3,1,2,D2,840
D,Paraguay,3,1,0,2,-2,D3,840
D,Costa Rica,3,1,0,3,-3,D4,840
A,Argentina,3,9,7,2,5,A1,841
A,Canada,3,6,6,4,2,A2,841
A,Peru,3,3,2,5,-3,A3,841
A,Chile,3,0,1,5,-4,A4,841
B,Mexico,3,7,2,0,2,B1,841
B,Jamaica,3,4,4,3,1,B2,841
B,Ecuador,3,4,3,2,1,B3,841
B,Venezuela,3,1,1,5,-4,B4,841
C,United States,3,7,9,2,7,C1,841
C,Panama,3,7,5,2,3,C2,841
C,Uruguay,3,3,2,3,-1,C3,841
C,Bolivia,3,0,2,11,-9,C4,841
D,Brazil,3,9,8,1,7,D1,841
D,Costa Rica,3,4,4,5,-1,D2,841
D,Colombia,3,2,1,2,-1,D3,841
D,Paraguay,3,1,2,7,-5,D4,841
A,Chile,3,9,5,1,4,A1,842
A,Argentina,3,6,6,3,3,A2,842
A,Canada,3,1,4,7,-3,A3,842
A,Peru,3,1,3,7,-4,A4,842
B,Venezuela,3,7,7,3,4,B1,842
B,Mexico,3,4,3,4,-1,B2,842
B,Ecuador,3,3,3,4,-1,B3,842
B,Jamaica,3,2,3,5,-2,B4,842
C,Uruguay,3,7,4,1,3,C1,842
C,United States,3,6,7,4,3,C2,842
C,Bolivia,3,4,5,5,0,C3,842
C,Panama,3,0,2,8,-6,C4,842
D,Brazil,3,9,6,1,5,D1,842
D,Colombia,3,6,6,2,4,D2,842
D,Paraguay,3,3,4,7,-3,D3,842
D,Costa Rica,3,0,1,7,-6,D4,842
A,Peru,3,9,3,0,3,A1,843
A,Argentina,3,3,3,3,0,A2,843
A,Chile,3,3,2,3,-1,A3,843
A,Canada,3,3,1,3,-2,A4,843
B,Mexico,3,7,4,1,3,B1,843
B,Venezuela,3,4,3,3,0,B2,843
B,Jamaica,3,4,3,4,-1,B3,843
B,Ecuador,3,1,1,3,-2,B4,843
C,United States,3,9,5,1,4,C1,843
C,Bolivia,3,4,3,3,0,C2,843
C,Uruguay,3,3,2,4,-2,C3,843
C,Panama,3,1,2,4,-2,C4,843
D,Brazil,3,7,7,1,6,D1,843
D,Colombia,3,5,2,0,2,D2,843
D,Costa Rica,3,2,1,6,-5,D3,843
D,Paraguay,3,1,2,5,-3,D4,843
A,Argentina,3,9,4,0,4,A1,844
A,Peru,3,3,3,3,0,A2,844
A,Canada,3,3,1,2,-1,A3,844
A,Chile,3,3,2,5,-3,A4,844
B,Ecuador,3,5,5,2,3,B1,844
B,Venezuela,3,4,3,1,2,B2,844
B,Mexico,3,4,3,5,-2,B3,844
B,Jamaica,3,2,0,3,-3,B4,844
C,Uruguay,3,9,8,1,7,C1,844
C,United States,3,6,10,6,4,C2,844
C,Bolivia,3,3,3,8,-5,C3,844
C,Panama,3,0,1,7,-6,C4,844
D,Brazil,3,9,7,0,7,D1,844
D,Costa Rica,3,3,2,4,-2,D2,844
D,Paraguay,3,3,1,3,-2,D3,844
D,Colombia,3,3,2,5,-3,D4,844
A,Argentina,3,7,7,1,6,A1,845
A,Chile,3,5,6,2,4,A2,845
A,Peru,3,4,2,3,-1,A3,845
A,Canada,3,0,2,11,-9,A4,845
B,Mexico,3,9,8,1,7,B1,845
B,Jamaica,3,4,3,2,1,B2,845
B,Ecuador,3,2,3,4,-1,B3,845
B,Venezuela,3,1,1,8,-7,B4,845
C,United States,3,6,6,3,3,C1,845
C,Panama,3,6,4,3,1,C2,845
C,Uruguay,3,4,3,3,0,C3,845
C,Bolivia,3,1,1,5,-4,C4,845
D,Brazil,3,9,9,1,8,D1,845
D,Paraguay,3,4,2,4,-2,D2,845
D,Colombia,3,3,1,3,-2,D3,845
D,Costa Rica,3,1,2,6,-4,D4,845
A,Canada,3,6,9,4,5,A1,846
A,Argentina,3,5,3,2,1,A2,846
A,Chile,3,2,4,7,-3,A3,846
A,Peru,3,2,3,6,-3,A4,846
B,Mexico,3,7,6,3,3,B1,846
B,Ecuador,3,4,4,4,0,B2,846
B,Jamaica,3,3,6,6,0,B3,846
B,Venezuela,3,3,1,4,-3,B4,846
C,Uruguay,3,7,5,1,4,C1,846
C,United States,3,7,5,2,3,C2,846
C,Panama,3,3,2,5,-3,C3,846
C,Bolivia,3,0,2,6,-4,C4,846
D,Colombia,3,7,5,1,4,D1,846
D,Brazil,3,7,4,1,3,D2,846
D,Costa Rica,3,1,1,4,-3,D3,846
D,Paraguay,3,1,1,5,-4,D4,846
A,Argentina,3,6,8,1,7,A1,847
A,Chile,3,4,2,4,-2,A2,847
A,Canada,3,4,2,6,-4,A3,847
A,Peru,3,3,3,4,-1,A4,847
B,Mexico,3,7,3,1,2,B1,847
B,Ecuador,3,6,5,2,3,B2,847
B,Jamaica,3,2,1,4,-3,B3,847
B,Venezuela,3,1,1,3,-2,B4,847
C,Uruguay,3,9,5,0,5,C1,847
C,United States,3,6,8,2,6,C2,847
C,Bolivia,3,1,1,6,-5,C3,847
C,Panama,3,1,0,6,-6,C4,847
D,Brazil,3,7,5,1,4,D1,847
D,Colombia,3,6,5,2,3,D2,847
D,Paraguay,3,2,1,5,-4,D3,847
D,Costa Rica,3,1,0,3,-3,D4,847
A,Peru,3,6,6,4,2,A1,848
A,Chile,3,6,4,2,2,A2,848
A,Argentina,3,3,3,4,-1,A3,848
A,Canada,3,3,5,8,-3,A4,848
B,Ecuador,3,7,3,1,2,B1,848
B,Jamaica,3,4,2,2,0,B2,848
B,Mexico,3,3,3,3,0,B3,848
B,Venezuela,3,3,2,4,-2,B4,848
C,United States,3,9,7,1,6,C1,848
C,Panama,3,6,7,4,3,C2,848
C,Bolivia,3,3,2,8,-6,C3,848
C,Uruguay,3,0,3,6,-3,C4,848
D,Colombia,3,7,5,3,2,D1,848
D,Brazil,3,6,6,1,5,D2,848
D,Paraguay,3,4,3,4,-1,D3,848
D,Costa Rica,3,0,1,7,-6,D4,848
A,Argentina,3,7,7,0,7,A1,849
A,Peru,3,6,5,3,2,A2,849
A,Chile,3,4,2,1,1,A3,849
A,Canada,3,0,2,12,-10,A4,849
B,Venezuela,3,6,6,4,2,B1,849
B,Ecuador,3,6,4,3,1,B2,849
B,Mexico,3,3,2,2,0,B3,849
B,Jamaica,3,3,4,7,-3,B4,849
C,United States,3,9,5,1,4,C1,849
C,Uruguay,3,6,5,3,2,C2,849
C,Panama,3,3,3,4,-1,C3,849
C,Bolivia,3,0,2,7,-5,C4,849
D,Brazil,3,9,11,0,11,D1,849
D,Colombia,3,6,2,2,0,D2,849
D,Paraguay,3,3,1,7,-6,D3,849
D,Costa Rica,3,0,0,5,-5,D4,849
A,Argentina,3,7,6,0,6,A1,850
A,Peru,3,7,3,0,3,A2,850
A,Chile,3,1,0,2,-2,A3,850
A,Canada,3,1,0,7,-7,A4,850
B,Ecuador,3,9,4,0,4,B1,850
B,Mexico,3,6,6,2,4,B2,850
B,Jamaica,3,3,2,4,-2,B3,850
B,Venezuela,3,0,1,7,-6,B4,850
C,Uruguay,3,9,7,2,5,C1,850
C,United States,3,4,4,4,0,C2,850
C,Bolivia,3,3,1,3,-2,C3,850
C,Panama,3,1,2,5,-3,C4,850
D,Brazil,3,7,7,1,6,D1,850
D,Colombia,3,6,2,3,-1,D2,850
D,Paraguay,3,3,1,4,-3,D3,850
D,Costa Rica,3,1,1,3,-2,D4,850
A,Peru,3,7,4,1,3,A1,851
A,Chile,3,5,3,2,1,A2,851
A,Argentina,3,4,5,4,1,A3,851
A,Canada,3,0,2,7,-5,A4,851
B,Venezuela,3,5,4,2,2,B1,851
B,Mexico,3,4,3,3,0,B2,851
B,Jamaica,3,4,3,4,-1,B3,851
B,Ecuador,3,2,1,2,-1,B4,851
C,United States,3,9,6,2,4,C1,851
C,Uruguay,3,6,5,3,2,C2,851
C,Bolivia,3,3,1,2,-1,C3,851
C,Panama,3,0,1,6,-5,C4,851
D,Brazil,3,9,9,1,8,D1,851
D,Colombia,3,6,4,3,1,D2,851
D,Paraguay,3,3,2,6,-4,D3,851
D,Costa Rica,3,0,1,6,-5,D4,851
A,Chile,3,7,5,2,3,A1,852
A,Peru,3,4,8,6,2,A2,852
A,Canada,3,4,2,4,-2,A3,852
A,Argentina,3,1,4,7,-3,A4,852
B,Ecuador,3,9,5,0,5,B1,852
B,Venezuela,3,4,4,4,0,B2,852
B,Mexico,3,2,2,3,-1,B3,852
B,Jamaica,3,1,2,6,-4,B4,852
C,Uruguay,3,6,8,5,3,C1,852
C,United States,3,4,3,2,1,C2,852
C,Bolivia,3,4,2,2,0,C3,852
C,Panama,3,2,1,5,-4,C4,852
D,Brazil,3,7,6,1,5,D1,852
D,Paraguay,3,6,4,3,1,D2,852
D,Colombia,3,2,2,5,-3,D3,852
D,Costa Rica,3,1,1,4,-3,D4,852
A,Canada,3,7,5,1,4,A1,853
A,Peru,3,5,2,1,1,A2,853
A,Argentina,3,3,2,5,-3,A3,853
A,Chile,3,1,3,5,-2,A4,853
B,Mexico,3,7,5,3,2,B1,853
B,Ecuador,3,6,9,3,6,B2,853
B,Venezuela,3,4,4,7,-3,B3,853
B,Jamaica,3,0,1,6,-5,B4,853
C,United States,3,9,8,3,5,C1,853
C,Uruguay,3,4,5,5,0,C2,853
C,Panama,3,3,6,6,0,C3,853
C,Bolivia,3,1,1,6,-5,C4,853
D,Brazil,3,7,6,2,4,D1,853
D,Colombia,3,6,5,4,1,D2,853
D,Paraguay,3,2,4,5,-1,D3,853
D,Costa Rica,3,1,1,5,-4,D4,853
A,Chile,3,7,4,1,3,A1,854
A,Peru,3,6,5,2,3,A2,854
A,Argentina,3,2,2,4,-2,A3,854
A,Canada,3,1,2,6,-4,A4,854
B,Mexico,3,7,6,2,4,B1,854
B,Ecuador,3,6,4,2,2,B2,854
B,Venezuela,3,4,4,5,-1,B3,854
B,Jamaica,3,0,2,7,-5,B4,854
C,Uruguay,3,6,11,2,9,C1,854
C,United States,3,6,5,4,1,C2,854
C,Panama,3,6,4,3,1,C3,854
C,Bolivia,3,0,2,13,-11,C4,854
D,Brazil,3,7,6,2,4,D1,854
D,Paraguay,3,5,3,2,1,D2,854
D,Costa Rica,3,2,2,5,-3,D3,854
D,Colombia,3,1,4,6,-2,D4,854
A,Argentina,3,5,2,0,2,A1,855
A,Chile,3,5,4,3,1,A2,855
A,Peru,3,3,1,3,-2,A3,855
A,Canada,3,2,3,4,-1,A4,855
B,Mexico,3,7,8,3,5,B1,855
B,Venezuela,3,6,3,3,0,B2,855
B,Jamaica,3,3,3,6,-3,B3,855
B,Ecuador,3,1,3,5,-2,B4,855
C,Uruguay,3,9,8,3,5,C1,855
C,United States,3,6,10,5,5,C2,855
C,Panama,3,3,4,6,-2,C3,855
C,Bolivia,3,0,1,9,-8,C4,855
D,Brazil,3,7,5,1,4,D1,855
D,Colombia,3,5,3,0,3,D2,855
D,Paraguay,3,4,2,2,0,D3,855
D,Costa Rica,3,0,0,7,-7,D4,855
A,Argentina,3,9,10,2,8,A1,856
A,Chile,3,4,3,2,1,A2,856
A,Canada,3,4,4,5,-1,A3,856
A,Peru,3,0,1,9,-8,A4,856
B,Mexico,3,6,7,4,3,B1,856
B,Venezuela,3,6,5,3,2,B2,856
B,Ecuador,3,6,3,1,2,B3,856
B,Jamaica,3,0,3,10,-7,B4,856
C,Uruguay,3,9,9,3,6,C1,856
C,United States,3,4,6,7,-1,C2,856
C,Bolivia,3,3,8,10,-2,C3,856
C,Panama,3,1,1,4,-3,C4,856
D,Brazil,3,9,7,0,7,D1,856
D,Colombia,3,4,2,2,0,D2,856
D,Paraguay,3,4,3,4,-1,D3,856
D,Costa Rica,3,0,0,6,-6,D4,856
A,Argentina,3,7,7,3,4,A1,857
A,Chile,3,5,4,3,1,A2,857
A,Peru,3,2,3,4,-1,A3,857
A,Canada,3,1,3,7,-4,A4,857
B,Mexico,3,7,5,1,4,B1,857
B,Ecuador,3,7,5,2,3,B2,857
B,Venezuela,3,3,3,4,-1,B3,857
B,Jamaica,3,0,2,8,-6,B4,857
C,Uruguay,3,9,8,3,5,C1,857
C,United States,3,6,8,4,4,C2,857
C,Panama,3,3,2,4,-2,C3,857
C,Bolivia,3,0,4,11,-7,C4,857
D,Brazil,3,7,5,1,4,D1,857
D,Paraguay,3,5,2,1,1,D2,857
D,Colombia,3,2,0,3,-3,D3,857
D,Costa Rica,3,1,0,2,-2,D4,857
A,Argentina,3,7,7,2,5,A1,858
A,Chile,3,6,6,2,4,A2,858
A,Canada,3,3,2,7,-5,A3,858
A,Peru,3,1,1,5,-4,A4,858
B,Mexico,3,5,3,1,2,B1,858
B,Venezuela,3,4,2,1,1,B2,858
B,Jamaica,3,4,2,2,0,B3,858
B,Ecuador,3,3,1,4,-3,B4,858
C,Uruguay,3,9,5,2,3,C1,858
C,United States,3,6,8,5,3,C2,858
C,Bolivia,3,3,5,5,0,C3,858
C,Panama,3,0,0,6,-6,C4,858
D,Brazil,3,9,7,0,7,D1,858
D,Costa Rica,3,4,4,4,0,D2,858
D,Colombia,3,3,3,7,-4,D3,858
D,Paraguay,3,1,1,4,-3,D4,858
A,Chile,3,7,3,1,2,A1,859
A,Argentina,3,4,6,4,2,A2,859
A,Peru,3,4,2,4,-2,A3,859
A,Canada,3,1,1,3,-2,A4,859
B,Mexico,3,9,5,0,5,B1,859
B,Ecuador,3,4,4,3,1,B2,859
B,Jamaica,3,2,2,4,-2,B3,859
B,Venezuela,3,1,0,4,-4,B4,859
C,United States,3,7,5,3,2,C1,859
C,Bolivia,3,5,2,1,1,C2,859
C,Panama,3,2,1,2,-1,C3,859
C,Uruguay,3,1,1,3,-2,C4,859
D,Brazil,3,7,6,0,6,D1,859
D,Colombia,3,5,2,1,1,D2,859
D,Costa Rica,3,3,2,6,-4,D3,859
D,Paraguay,3,1,0,3,-3,D4,859
A,Argentina,3,7,5,2,3,A1,860
A,Chile,3,6,6,1,5,A2,860
A,Canada,3,3,3,7,-4,A3,860
A,Peru,3,1,4,8,-4,A4,860
B,Mexico,3,7,5,2,3,B1,860
B,Ecuador,3,4,3,3,0,B2,860
B,Jamaica,3,2,2,3,-1,B3,860
B,Venezuela,3,2,2,4,-2,B4,860
C,Uruguay,3,7,7,2,5,C1,860
C,United States,3,6,9,5,4,C2,860
C,Bolivia,3,2,1,4,-3,C3,860
C,Panama,3,1,3,9,-6,C4,860
D,Brazil,3,7,6,3,3,D1,860
D,Colombia,3,5,5,2,3,D2,860
D,Paraguay,3,3,4,6,-2,D3,860
D,Costa Rica,3,1,0,4,-4,D4,860
A,Argentina,3,9,5,1,4,A1,861
A,Peru,3,4,5,4,1,A2,861
A,Chile,3,4,1,1,0,A3,861
A,Canada,3,0,2,7,-5,A4,861
B,Jamaica,3,5,6,3,3,B1,861
B,Venezuela,3,5,4,3,1,B2,861
B,Ecuador,3,4,6,4,2,B3,861
B,Mexico,3,1,1,7,-6,B4,861
C,United States,3,9,6,0,6,C1,861
C,Uruguay,3,6,4,1,3,C2,861
C,Bolivia,3,3,2,5,-3,C3,861
C,Panama,3,0,0,6,-6,C4,861
D,Brazil,3,7,8,1,7,D1,861
D,Colombia,3,6,5,3,2,D2,861
D,Costa Rica,3,3,2,9,-7,D3,861
D,Paraguay,3,1,1,3,-2,D4,861
A,Peru,3,7,3,0,3,A1,862
A,Argentina,3,5,3,1,2,A2,862
A,Chile,3,3,3,6,-3,A3,862
A,Canada,3,1,1,3,-2,A4,862
B,Venezuela,3,5,6,5,1,B1,862
B,Mexico,3,5,2,1,1,B2,862
B,Ecuador,3,2,3,4,-1,B3,862
B,Jamaica,3,2,3,4,-1,B4,862
C,United States,3,7,8,3,5,C1,862
C,Uruguay,3,5,8,2,6,C2,862
C,Panama,3,4,3,3,0,C3,862
C,Bolivia,3,0,1,12,-11,C4,862
D,Brazil,3,7,6,1,5,D1,862
D,Colombia,3,4,6,4,2,D2,862
D,Costa Rica,3,4,1,3,-2,D3,862
D,Paraguay,3,1,2,7,-5,D4,862
A,Argentina,3,6,8,5,3,A1,863
A,Chile,3,5,4,2,2,A2,863
A,Canada,3,2,3,5,-2,A3,863
A,Peru,3,2,2,5,-3,A4,863
B,Mexico,3,9,8,1,7,B1,863
B,Ecuador,3,3,6,2,4,B2,863
B,Venezuela,3,3,4,8,-4,B3,863
B,Jamaica,3,3,2,9,-7,B4,863
C,United States,3,7,8,4,4,C1,863
C,Bolivia,3,4,4,5,-1,C2,863
C,Uruguay,3,4,1,2,-1,C3,863
C,Panama,3,1,3,5,-2,C4,863
D,Brazil,3,9,8,0,8,D1,863
D,Colombia,3,6,3,2,1,D2,863
D,Costa Rica,3,3,3,6,-3,D3,863
D,Paraguay,3,0,1,7,-6,D4,863
A,Peru,3,9,7,4,3,A1,864
A,Argentina,3,4,6,6,0,A2,864
A,Canada,3,3,5,6,-1,A3,864
A,Chile,3,1,3,5,-2,A4,864
B,Mexico,3,9,6,1,5,B1,864
B,Venezuela,3,4,1,2,-1,B2,864
B,Ecuador,3,3,2,4,-2,B3,864
B,Jamaica,3,1,2,4,-2,B4,864
C,Uruguay,3,7,9,3,6,C1,864
C,Panama,3,4,4,4,0,C2,864
C,Bolivia,3,3,3,8,-5,C3,864
C,United States,3,2,2,3,-1,C4,864
D,Colombia,3,7,5,0,5,D1,864
D,Brazil,3,6,4,3,1,D2,864
D,Costa Rica,3,3,2,6,-4,D3,864
D,Paraguay,3,1,1,3,-2,D4,864
A,Argentina,3,7,7,1,6,A1,865
A,Chile,3,4,3,4,-1,A2,865
A,Canada,3,4,3,6,-3,A3,865
A,Peru,3,1,1,3,-2,A4,865
B,Ecuador,3,9,6,1,5,B1,865
B,Venezuela,3,6,4,2,2,B2,865
B,Mexico,3,3,1,3,-2,B3,865
B,Jamaica,3,0,0,5,-5,B4,865
C,United States,3,9,6,2,4,C1,865
C,Bolivia,3,4,4,3,1,C2,865
C,Uruguay,3,4,3,3,0,C3,865
C,Panama,3,0,2,7,-5,C4,865
D,Brazil,3,9,5,1,4,D1,865
D,Paraguay,3,4,2,3,-1,D2,865
D,Costa Rica,3,3,2,2,0,D3,865
D,Colombia,3,1,0,3,-3,D4,865
A,Argentina,3,6,5,4,1,A1,866
A,Canada,3,4,2,2,0,A2,866
A,Chile,3,4,4,5,-1,A3,866
A,Peru,3,3,5,5,0,A4,866
B,Venezuela,3,6,5,1,4,B1,866
B,Mexico,3,4,2,3,-1,B2,866
B,Jamaica,3,4,3,5,-2,B3,866
B,Ecuador,3,3,2,3,-1,B4,866
C,Uruguay,3,7,6,3,3,C1,866
C,United States,3,7,3,0,3,C2,866
C,Bolivia,3,1,2,4,-2,C3,866
C,Panama,3,1,3,7,-4,C4,866
D,Brazil,3,9,5,0,5,D1,866
D,Colombia,3,4,1,1,0,D2,866
D,Costa Rica,3,2,1,2,-1,D3,866
D,Paraguay,3,1,1,5,-4,D4,866
A,Argentina,3,7,6,1,5,A1,867
A,Chile,3,4,3,4,-1,A2,867
A,Peru,3,3,4,6,-2,A3,867
A,Canada,3,3,3,5,-2,A4,867
B,Mexico,3,9,6,2,4,B1,867
B,Jamaica,3,4,4,4,0,B2,867
B,Venezuela,3,3,2,4,-2,B3,867
B,Ecuador,3,1,2,4,-2,B4,867
C,United States,3,9,5,0,5,C1,867
C,Uruguay,3,6,9,2,7,C2,867
C,Panama,3,3,4,6,-2,C3,867
C,Bolivia,3,0,0,10,-10,C4,867
D,Brazil,3,9,8,2,6,D1,867
D,Paraguay,3,6,5,4,1,D2,867
D,Colombia,3,1,1,3,-2,D3,867
D,Costa Rica,3,1,1,6,-5,D4,867
A,Peru,3,5,5,1,4,A1,868
A,Argentina,3,5,5,3,2,A2,868
A,Chile,3,2,1,3,-2,A3,868
A,Canada,3,2,3,7,-4,A4,868
B,Venezuela,3,7,6,2,4,B1,868
B,Mexico,3,4,5,5,0,B2,868
B,Ecuador,3,3,2,2,0,B3,868
B,Jamaica,3,1,0,4,-4,B4,868
C,Bolivia,3,7,5,3,2,C1,868
C,Uruguay,3,7,4,2,2,C2,868
C,United States,3,3,6,4,2,C3,868
C,Panama,3,0,1,7,-6,C4,868
D,Brazil,3,9,5,0,5,D1,868
D,Colombia,3,6,6,2,4,D2,868
D,Paraguay,3,3,4,7,-3,D3,868
D,Costa Rica,3,0,1,7,-6,D4,868
A,Argentina,3,7,4,2,2,A1,869
A,Chile,3,5,3,2,1,A2,869
A,Canada,3,3,7,7,0,A3,869
A,Peru,3,1,1,4,-3,A4,869
B,Jamaica,3,7,7,5,2,B1,869
B,Ecuador,3,4,4,4,0,B2,869
B,Venezuela,3,2,2,3,-1,B3,869
B,Mexico,3,2,0,1,-1,B4,869
C,United States,3,5,7,4,3,C1,869
C,Uruguay,3,5,5,4,1,C2,869
C,Panama,3,5,2,1,1,C3,869
C,Bolivia,3,0,1,6,-5,C4,869
D,Brazil,3,6,5,3,2,D1,869
D,Costa Rica,3,6,5,3,2,D2,869
D,Colombia,3,6,4,3,1,D3,869
D,Paraguay,3,0,1,6,-5,D4,869
A,Chile,3,6,5,2,3,A1,870
A,Argentina,3,6,3,2,1,A2,870
A,Peru,3,3,1,2,-1,A3,870
A,Canada,3,3,3,6,-3,A4,870
B,Venezuela,3,7,5,1,4,B1,870
B,Ecuador,3,7,4,1,3,B2,870
B,Mexico,3,3,3,2,1,B3,870
B,Jamaica,3,0,0,8,-8,B4,870
C,United States,3,9,8,1,7,C1,870
C,Uruguay,3,6,6,3,3,C2,870
C,Panama,3,3,3,8,-5,C3,870
C,Bolivia,3,0,1,6,-5,C4,870
D,Brazil,3,9,9,0,9,D1,870
D,Colombia,3,4,1,1,0,D2,870
D,Costa Rica,3,3,1,6,-5,D3,870
D,Paraguay,3,1,0,4,-4,D4,870
A,Argentina,3,7,4,0,4,A1,871
A,Chile,3,5,2,1,1,A2,871
A,Peru,3,2,1,2,-1,A3,871
A,Canada,3,1,0,4,-4,A4,871
B,Ecuador,3,5,2,1,1,B1,871
B,Mexico,3,5,2,1,1,B2,871
B,Venezuela,3,3,1,1,0,B3,871
B,Jamaica,3,1,3,5,-2,B4,871
C,Panama,3,5,7,5,2,C1,871
C,United States,3,4,4,3,1,C2,871
C,Bolivia,3,4,3,4,-1,C3,871
C,Uruguay,3,3,7,9,-2,C4,871
D,Brazil,3,7,4,2,2,D1,871
D,Paraguay,3,5,3,2,1,D2,871
D,Costa Rica,3,2,1,2,-1,D3,871
D,Colombia,3,1,1,3,-2,D4,871
A,Argentina,3,7,6,1,5,A1,872
A,Chile,3,4,2,3,-1,A2,872
A,Peru,3,3,2,4,-2,A3,872
A,Canada,3,2,2,4,-2,A4,872
B,Ecuador,3,9,6,2,4,B1,872
B,Mexico,3,4,4,3,1,B2,872
B,Jamaica,3,2,3,4,-1,B3,872
B,Venezuela,3,1,1,5,-4,B4,872
C,United States,3,7,9,4,5,C1,872
C,Panama,3,6,3,4,-1,C2,872
C,Bolivia,3,3,4,5,-1,C3,872
C,Uruguay,3,1,1,4,-3,C4,872
D,Colombia,3,7,5,2,3,D1,872
D,Brazil,3,7,3,0,3,D2,872
D,Paraguay,3,1,1,3,-2,D3,872
D,Costa Rica,3,1,1,5,-4,D4,872
A,Canada,3,7,3,1,2,A1,873
A,Chile,3,4,3,3,0,A2,873
A,Peru,3,3,3,4,-1,A3,873
A,Argentina,3,3,2,3,-1,A4,873
B,Venezuela,3,6,5,3,2,B1,873
B,Mexico,3,4,5,3,2,B2,873
B,Ecuador,3,4,3,3,0,B3,873
B,Jamaica,3,3,4,8,-4,B4,873
C,United States,3,9,8,1,7,C1,873
C,Bolivia,3,6,5,5,0,C2,873
C,Uruguay,3,3,4,4,0,C3,873
C,Panama,3,0,2,9,-7,C4,873
D,Brazil,3,7,6,2,4,D1,873
D,Colombia,3,5,4,3,1,D2,873
D,Paraguay,3,4,3,5,-2,D3,873
D,Costa Rica,3,0,1,4,-3,D4,873
A,Argentina,3,9,7,2,5,A1,874
A,Chile,3,4,3,2,1,A2,874
A,Canada,3,4,2,4,-2,A3,874
A,Peru,3,0,0,4,-4,A4,874
B,Mexico,3,9,3,0,3,B1,874
B,Ecuador,3,4,4,4,0,B2,874
B,Venezuela,3,2,1,2,-1,B3,874
B,Jamaica,3,1,2,4,-2,B4,874
C,United States,3,7,4,2,2,C1,874
C,Panama,3,4,1,1,0,C2,874
C,Bolivia,3,3,3,4,-1,C3,874
C,Uruguay,3,2,2,3,-1,C4,874
D,Brazil,3,9,8,1,7,D1,874
D,Colombia,3,4,1,3,-2,D2,874
D,Paraguay,3,2,1,4,-3,D3,874
D,Costa Rica,3,1,0,2,-2,D4,874
A,Argentina,3,5,4,3,1,A1,875
A,Peru,3,4,5,4,1,A2,875
A,Chile,3,4,3,4,-1,A3,875
A,Canada,3,2,2,3,-1,A4,875
B,Venezuela,3,7,8,3,5,B1,875
B,Mexico,3,6,7,4,3,B2,875
B,Ecuador,3,4,5,7,-2,B3,875
B,Jamaica,3,0,3,9,-6,B4,875
C,United States,3,9,7,2,5,C1,875
C,Uruguay,3,6,5,3,2,C2,875
C,Bolivia,3,1,2,4,-2,C3,875
C,Panama,3,1,1,6,-5,C4,875
D,Colombia,3,9,5,1,4,D1,875
D,Brazil,3,6,7,1,6,D2,875
D,Paraguay,3,3,2,4,-2,D3,875
D,Costa Rica,3,0,1,9,-8,D4,875
A,Argentina,3,9,10,5,5,A1,876
A,Chile,3,2,4,5,-1,A2,876
A,Peru,3,2,2,3,-1,A3,876
A,Canada,3,2,3,6,-3,A4,876
B,Venezuela,3,9,5,1,4,B1,876
B,Mexico,3,6,3,1,2,B2,876
B,Jamaica,3,3,2,4,-2,B3,876
B,Ecuador,3,0,0,4,-4,B4,876
C,United States,3,9,6,2,4,C1,876
C,Uruguay,3,6,6,4,2,C2,876
C,Panama,3,3,5,6,-1,C3,876
C,Bolivia,3,0,3,8,-5,C4,876
D,Brazil,3,9,6,1,5,D1,876
D,Costa Rica,3,4,2,3,-1,D2,876
D,Colombia,3,3,3,4,-1,D3,876
D,Paraguay,3,1,0,3,-3,D4,876
A,Argentina,3,9,5,0,5,A1,877
A,Canada,3,4,6,4,2,A2,877
A,Peru,3,3,2,6,-4,A3,877
A,Chile,3,1,1,4,-3,A4,877
B,Ecuador,3,9,5,1,4,B1,877
B,Venezuela,3,4,6,7,-1,B2,877
B,Mexico,3,3,4,4,0,B3,877
B,Jamaica,3,1,4,7,-3,B4,877
C,United States,3,7,7,1,6,C1,877
C,Uruguay,3,7,6,4,2,C2,877
C,Panama,3,1,4,6,-2,C3,877
C,Bolivia,3,1,7,13,-6,C4,877
D,Brazil,3,5,1,0,1,D1,877
D,Paraguay,3,3,2,2,0,D2,877
D,Colombia,3,3,1,1,0,D3,877
D,Costa Rica,3,2,1,2,-1,D4,877
A,Argentina,3,9,8,2,6,A1,878
A,Chile,3,3,5,6,-1,A2,878
A,Peru,3,3,4,5,-1,A3,878
A,Canada,3,3,2,6,-4,A4,878
B,Ecuador,3,6,6,2,4,B1,878
B,Mexico,3,6,3,5,-2,B2,878
B,Venezuela,3,4,3,3,0,B3,878
B,Jamaica,3,1,1,3,-2,B4,878
C,United States,3,7,6,2,4,C1,878
C,Panama,3,4,4,3,1,C2,878
C,Bolivia,3,3,3,6,-3,C3,878
C,Uruguay,3,2,2,4,-2,C4,878
D,Colombia,3,7,5,1,4,D1,878
D,Brazil,3,6,6,3,3,D2,878
D,Paraguay,3,3,4,8,-4,D3,878
D,Costa Rica,3,1,4,7,-3,D4,878
A,Argentina,3,6,3,2,1,A1,879
A,Canada,3,4,5,4,1,A2,879
A,Chile,3,4,3,3,0,A3,879
A,Peru,3,3,3,5,-2,A4,879
B,Mexico,3,6,7,3,4,B1,879
B,Ecuador,3,6,4,1,3,B2,879
B,Venezuela,3,6,4,6,-2,B3,879
B,Jamaica,3,0,0,5,-5,B4,879
C,Uruguay,3,7,7,3,4,C1,879
C,Bolivia,3,4,3,4,-1,C2,879
C,United States,3,3,3,3,0,C3,879
C,Panama,3,3,5,8,-3,C4,879
D,Colombia,3,7,7,2,5,D1,879
D,Brazil,3,4,5,3,2,D2,879
D,Costa Rica,3,4,1,4,-3,D3,879
D,Paraguay,3,1,0,4,-4,D4,879
A,Chile,3,7,6,3,3,A1,880
A,Argentina,3,6,7,2,5,A2,880
A,Canada,3,4,3,6,-3,A3,880
A,Peru,3,0,2,7,-5,A4,880
B,Ecuador,3,6,6,3,3,B1,880
B,Mexico,3,6,4,4,0,B2,880
B,Jamaica,3,3,4,5,-1,B3,880
B,Venezuela,3,3,3,5,-2,B4,880
C,Uruguay,3,7,8,1,7,C1,880
C,United States,3,5,7,3,4,C2,880
C,Panama,3,3,7,9,-2,C3,880
C,Bolivia,3,1,0,9,-9,C4,880
D,Colombia,3,7,4,2,2,D1,880
D,Brazil,3,6,4,1,3,D2,880
D,Paraguay,3,2,0,2,-2,D3,880
D,Costa Rica,3,1,2,5,-3,D4,880
A,Argentina,3,6,5,2,3,A1,881
A,Canada,3,6,4,4,0,A2,881
A,Peru,3,3,3,3,0,A3,881
A,Chile,3,3,2,5,-3,A4,881
B,Venezuela,3,7,4,1,3,B1,881
B,Mexico,3,3,1,1,0,B2,881
B,Ecuador,3,2,1,2,-1,B3,881
B,Jamaica,3,2,1,3,-2,B4,881
C,Panama,3,7,7,5,2,C1,881
C,Uruguay,3,4,8,4,4,C2,881
C,United States,3,3,3,3,0,C3,881
C,Bolivia,3,1,3,9,-6,C4,881
D,Brazil,3,7,5,1,4,D1,881
D,Colombia,3,5,3,1,2,D2,881
D,Paraguay,3,2,2,5,-3,D3,881
D,Costa Rica,3,1,2,5,-3,D4,881
A,Argentina,3,7,7,2,5,A1,882
A,Peru,3,5,4,3,1,A2,882
A,Chile,3,4,4,4,0,A3,882
A,Canada,3,0,3,9,-6,A4,882
B,Ecuador,3,7,5,0,5,B1,882
B,Mexico,3,7,3,1,2,B2,882
B,Venezuela,3,3,6,5,1,B3,882
B,Jamaica,3,0,1,9,-8,B4,882
C,Uruguay,3,7,8,1,7,C1,882
C,United States,3,4,2,2,0,C2,882
C,Panama,3,3,2,5,-3,C3,882
C,Bolivia,3,3,2,6,-4,C4,882
D,Brazil,3,7,6,0,6,D1,882
D,Costa Rica,3,4,3,5,-2,D2,882
D,Paraguay,3,2,2,4,-2,D3,882
D,Colombia,3,2,1,3,-2,D4,882
A,Argentina,3,7,8,5,3,A1,883
A,Chile,3,4,6,4,2,A2,883
A,Canada,3,2,2,4,-2,A3,883
A,Peru,3,2,2,5,-3,A4,883
B,Mexico,3,5,2,1,1,B1,883
B,Jamaica,3,4,4,3,1,B2,883
B,Venezuela,3,4,2,6,-4,B3,883
B,Ecuador,3,3,7,5,2,B4,883
C,Uruguay,3,7,8,4,4,C1,883
C,United States,3,7,6,3,3,C2,883
C,Bolivia,3,3,3,5,-2,C3,883
C,Panama,3,0,2,7,-5,C4,883
D,Colombia,3,6,6,2,4,D1,883
D,Brazil,3,6,5,2,3,D2,883
D,Paraguay,3,3,2,4,-2,D3,883
D,Costa Rica,3,3,2,7,-5,D4,883
A,Argentina,3,7,5,0,5,A1,884
A,Canada,3,7,5,2,3,A2,884
A,Peru,3,1,1,3,-2,A3,884
A,Chile,3,1,1,7,-6,A4,884
B,Mexico,3,5,6,3,3,B1,884
B,Venezuela,3,4,4,4,0,B2,884
B,Jamaica,3,4,3,3,0,B3,884
B,Ecuador,3,3,4,7,-3,B4,884
C,Uruguay,3,9,9,0,9,C1,884
C,Panama,3,4,2,4,-2,C2,884
C,United States,3,3,3,4,-1,C3,884
C,Bolivia,3,1,1,7,-6,C4,884
D,Brazil,3,7,6,0,6,D1,884
D,Colombia,3,4,2,2,0,D2,884
D,Paraguay,3,3,2,5,-3,D3,884
D,Costa Rica,3,3,1,4,-3,D4,884
A,Peru,3,7,6,3,3,A1,885
A,Argentina,3,5,3,1,2,A2,885
A,Canada,3,2,2,3,-1,A3,885
A,Chile,3,1,2,6,-4,A4,885
B,Mexico,3,6,3,2,1,B1,885
B,Ecuador,3,4,3,2,1,B2,885
B,Jamaica,3,4,3,4,-1,B3,885
B,Venezuela,3,3,2,3,-1,B4,885
C,Uruguay,3,9,7,1,6,C1,885
C,Panama,3,6,5,4,1,C2,885
C,United States,3,3,3,4,-1,C3,885
C,Bolivia,3,0,2,8,-6,C4,885
D,Colombia,3,7,5,0,5,D1,885
D,Brazil,3,7,4,2,2,D2,885
D,Paraguay,3,3,3,3,0,D3,885
D,Costa Rica,3,0,3,10,-7,D4,885
A,Argentina,3,7,7,3,4,A1,886
A,Canada,3,5,4,3,1,A2,886
A,Chile,3,2,4,6,-2,A3,886
A,Peru,3,1,2,5,-3,A4,886
B,Venezuela,3,7,9,4,5,B1,886
B,Mexico,3,5,5,4,1,B2,886
B,Ecuador,3,4,4,4,0,B3,886
B,Jamaica,3,0,2,8,-6,B4,886
C,Bolivia,3,7,6,3,3,C1,886
C,Uruguay,3,4,5,3,2,C2,886
C,Panama,3,3,3,7,-4,C3,886
C,United States,3,2,2,3,-1,C4,886
D,Colombia,3,6,5,3,2,D1,886
D,Brazil,3,5,4,2,2,D2,886
D,Paraguay,3,4,4,6,-2,D3,886
D,Costa Rica,3,1,2,4,-2,D4,886
A,Chile,3,7,3,1,2,A1,887
A,Peru,3,5,5,3,2,A2,887
A,Canada,3,4,3,3,0,A3,887
A,Argentina,3,0,2,6,-4,A4,887
B,Ecuador,3,9,7,3,4,B1,887
B,Mexico,3,4,7,6,1,B2,887
B,Jamaica,3,3,2,4,-2,B3,887
B,Venezuela,3,1,5,8,-3,B4,887
C,Uruguay,3,7,9,2,7,C1,887
C,Panama,3,5,6,4,2,C2,887
C,United States,3,3,10,9,1,C3,887
C,Bolivia,3,1,4,14,-10,C4,887
D,Brazil,3,7,5,0,5,D1,887
D,Colombia,3,7,5,2,3,D2,887
D,Paraguay,3,3,4,6,-2,D3,887
D,Costa Rica,3,0,2,8,-6,D4,887
A,Argentina,3,7,5,2,3,A1,888
A,Peru,3,4,4,4,0,A2,888
A,Canada,3,3,2,3,-1,A3,888
A,Chile,3,3,3,5,-2,A4,888
B,Ecuador,3,7,4,1,3,B1,888
B,Venezuela,3,4,3,3,0,B2,888
B,Mexico,3,4,2,2,0,B3,888
B,Jamaica,3,1,0,3,-3,B4,888
C,United States,3,7,6,3,3,C1,888
C,Bolivia,3,4,3,3,0,C2,888
C,Uruguay,3,3,3,4,-1,C3,888
C,Panama,3,3,2,4,-2,C4,888
D,Paraguay,3,6,2,2,0,D1,888
D,Costa Rica,3,4,5,2,3,D2,888
D,Brazil,3,4,4,3,1,D3,888
D,Colombia,3,3,3,7,-4,D4,888
A,Argentina,3,7,7,2,5,A1,889
A,Canada,3,4,3,3,0,A2,889
A,Chile,3,2,1,2,-1,A3,889
A,Peru,3,2,1,5,-4,A4,889
B,Jamaica,3,6,6,2,4,B1,889
B,Mexico,3,4,3,3,0,B2,889
B,Venezuela,3,4,3,4,-1,B3,889
B,Ecuador,3,2,3,6,-3,B4,889
C,United States,3,9,6,0,6,C1,889
C,Uruguay,3,3,4,3,1,C2,889
C,Panama,3,3,2,4,-2,C3,889
C,Bolivia,3,3,3,8,-5,C4,889
D,Brazil,3,7,6,2,4,D1,889
D,Colombia,3,7,3,1,2,D2,889
D,Paraguay,3,1,2,4,-2,D3,889
D,Costa Rica,3,1,1,5,-4,D4,889
A,Argentina,3,5,3,1,2,A1,890
A,Chile,3,5,3,2,1,A2,890
A,Canada,3,4,2,3,-1,A3,890
A,Peru,3,1,2,4,-2,A4,890
B,Ecuador,3,4,4,3,1,B1,890
B,Venezuela,3,4,2,2,0,B2,890
B,Mexico,3,4,3,4,-1,B3,890
B,Jamaica,3,3,3,3,0,B4,890
C,United States,3,9,8,2,6,C1,890
C,Uruguay,3,6,5,2,3,C2,890
C,Panama,3,3,4,6,-2,C3,890
C,Bolivia,3,0,2,9,-7,C4,890
D,Brazil,3,5,2,1,1,D1,890
D,Colombia,3,5,1,0,1,D2,890
D,Paraguay,3,3,1,1,0,D3,890
D,Costa Rica,3,1,0,2,-2,D4,890
A,Argentina,3,6,5,3,2,A1,891
A,Chile,3,6,5,4,1,A2,891
A,Peru,3,6,3,3,0,A3,891
A,Canada,3,0,2,5,-3,A4,891
B,Jamaica,3,6,6,5,1,B1,891
B,Venezuela,3,4,4,5,-1,B2,891
B,Ecuador,3,4,3,4,-1,B3,891
B,Mexico,3,3,4,3,1,B4,891
C,United States,3,5,5,3,2,C1,891
C,Bolivia,3,4,8,5,3,C2,891
C,Panama,3,4,3,3,0,C3,891
C,Uruguay,3,3,2,7,-5,C4,891
D,Brazil,3,7,10,4,6,D1,891
D,Colombia,3,7,8,3,5,D2,891
D,Costa Rica,3,1,1,5,-4,D3,891
D,Paraguay,3,1,2,9,-7,D4,891
A,Argentina,3,5,6,3,3,A1,892
A,Chile,3,5,8,7,1,A2,892
A,Canada,3,4,9,7,2,A3,892
A,Peru,3,1,4,10,-6,A4,892
B,Ecuador,3,5,3,1,2,B1,892
B,Mexico,3,5,4,3,1,B2,892
B,Jamaica,3,2,2,3,-1,B3,892
B,Venezuela,3,2,2,4,-2,B4,892
C,United States,3,5,3,2,1,C1,892
C,Uruguay,3,5,3,2,1,C2,892
C,Bolivia,3,4,2,2,0,C3,892
C,Panama,3,1,1,3,-2,C4,892
D,Brazil,3,9,7,1,6,D1,892
D,Colombia,3,4,5,3,2,D2,892
D,Paraguay,3,2,1,3,-2,D3,892
D,Costa Rica,3,1,1,7,-6,D4,892
A,Argentina,3,7,4,1,3,A1,893
A,Peru,3,4,3,3,0,A2,893
A,Canada,3,3,2,4,-2,A3,893
A,Chile,3,2,2,3,-1,A4,893
B,Ecuador,3,7,5,1,4,B1,893
B,Venezuela,3,3,1,1,0,B2,893
B,Mexico,3,2,1,2,-1,B3,893
B,Jamaica,3,2,1,4,-3,B4,893
C,United States,3,7,7,3,4,C1,893
C,Uruguay,3,6,4,3,1,C2,893
C,Panama,3,3,3,5,-2,C3,893
C,Bolivia,3,1,4,7,-3,C4,893
D,Brazil,3,6,4,2,2,D1,893
D,Paraguay,3,4,3,2,1,D2,893
D,Colombia,3,4,1,1,0,D3,893
D,Costa Rica,3,2,1,4,-3,D4,893
A,Argentina,3,7,7,3,4,A1,894
A,Peru,3,6,6,2,4,A2,894
A,Canada,3,3,4,8,-4,A3,894
A,Chile,3,1,3,7,-4,A4,894
B,Jamaica,3,5,4,2,2,B1,894
B,Ecuador,3,4,4,3,1,B2,894
B,Mexico,3,4,3,4,-1,B3,894
B,Venezuela,3,3,2,4,-2,B4,894
C,Panama,3,6,6,3,3,C1,894
C,Uruguay,3,4,4,4,0,C2,894
C,Bolivia,3,4,2,4,-2,C3,894
C,United States,3,2,2,3,-1,C4,894
D,Colombia,3,9,4,1,3,D1,894
D,Brazil,3,6,7,3,4,D2,894
D,Paraguay,3,1,0,3,-3,D3,894
D,Costa Rica,3,1,3,7,-4,D4,894
A,Peru,3,6,3,2,1,A1,895
A,Chile,3,4,3,2,1,A2,895
A,Argentina,3,4,2,2,0,A3,895
A,Canada,3,3,2,4,-2,A4,895
B,Mexico,3,7,3,0,3,B1,895
B,Jamaica,3,4,3,3,0,B2,895
B,Venezuela,3,3,4,5,-1,B3,895
B,Ecuador,3,3,2,4,-2,B4,895
C,Uruguay,3,7,9,2,7,C1,895
C,United States,3,7,6,4,2,C2,895
C,Bolivia,3,1,4,8,-4,C3,895
C,Panama,3,1,2,7,-5,C4,895
D,Brazil,3,6,3,1,2,D1,895
D,Costa Rica,3,4,1,1,0,D2,895
D,Paraguay,3,4,1,2,-1,D3,895
D,Colombia,3,3,1,2,-1,D4,895
A,Argentina,3,9,8,0,8,A1,896
A,Chile,3,6,3,4,-1,A2,896
A,Canada,3,3,2,4,-2,A3,896
A,Peru,3,0,0,5,-5,A4,896
B,Ecuador,3,9,5,1,4,B1,896
B,Mexico,3,6,5,2,3,B2,896
B,Jamaica,3,1,1,4,-3,B3,896
B,Venezuela,3,1,1,5,-4,B4,896
C,Uruguay,3,9,9,1,8,C1,896
C,United States,3,6,5,5,0,C2,896
C,Bolivia,3,1,2,6,-4,C3,896
C,Panama,3,1,2,6,-4,C4,896
D,Colombia,3,6,7,3,4,D1,896
D,Brazil,3,6,5,4,1,D2,896
D,Paraguay,3,4,2,2,0,D3,896
D,Costa Rica,3,1,0,5,-5,D4,896
A,Argentina,3,6,6,4,2,A1,897
A,Chile,3,6,6,4,2,A2,897
A,Canada,3,3,2,2,0,A3,897
A,Peru,3,3,2,6,-4,A4,897
B,Ecuador,3,7,3,1,2,B1,897
B,Jamaica,3,4,3,4,-1,B2,897
B,Mexico,3,3,6,6,0,B3,897
B,Venezuela,3,3,4,5,-1,B4,897
C,United States,3,9,6,2,4,C1,897
C,Uruguay,3,4,4,3,1,C2,897
C,Panama,3,4,3,2,1,C3,897
C,Bolivia,3,0,1,7,-6,C4,897
D,Brazil,3,7,7,2,5,D1,897
D,Costa Rica,3,5,3,2,1,D2,897
D,Colombia,3,2,0,1,-1,D3,897
D,Paraguay,3,1,2,7,-5,D4,897
A,Peru,3,6,3,2,1,A1,898
A,Argentina,3,4,2,1,1,A2,898
A,Chile,3,4,4,4,0,A3,898
A,Canada,3,3,3,5,-2,A4,898
B,Mexico,3,7,3,1,2,B1,898
B,Ecuador,3,4,1,1,0,B2,898
B,Jamaica,3,3,4,5,-1,B3,898
B,Venezuela,3,2,2,3,-1,B4,898
C,Uruguay,3,7,6,0,6,C1,898
C,United States,3,7,4,0,4,C2,898
C,Panama,3,3,4,4,0,C3,898
C,Bolivia,3,0,0,10,-10,C4,898
D,Colombia,3,9,6,1,5,D1,898
D,Brazil,3,6,5,3,2,D2,898
D,Costa Rica,3,1,1,4,-3,D3,898
D,Paraguay,3,1,2,6,-4,D4,898
A,Argentina,3,7,7,3,4,A1,899
A,Peru,3,4,3,3,0,A2,899
A,Chile,3,2,1,2,-1,A3,899
A,Canada,3,2,2,5,-3,A4,899
B,Mexico,3,9,7,0,7,B1,899
B,Jamaica,3,4,2,4,-2,B2,899
B,Ecuador,3,2,1,3,-2,B3,899
B,Venezuela,3,1,1,4,-3,B4,899
C,Panama,3,7,5,3,2,C1,899
C,Uruguay,3,4,4,4,0,C2,899
C,Bolivia,3,2,2,3,-1,C3,899
C,United States,3,2,2,3,-1,C4,899
D,Paraguay,3,6,5,6,-1,D1,899
D,Brazil,3,5,5,2,3,D2,899
D,Colombia,3,4,5,4,1,D3,899
D,Costa Rica,3,1,2,5,-3,D4,899
A,Peru,3,7,6,2,4,A1,900
A,Chile,3,7,5,2,3,A2,900
A,Argentina,3,3,5,6,-1,A3,900
A,Canada,3,0,1,7,-6,A4,900
B,Mexico,3,7,4,1,3,B1,900
B,Jamaica,3,4,2,2,0,B2,900
B,Venezuela,3,3,2,4,-2,B3,900
B,Ecuador,3,2,1,2,-1,B4,900
C,United States,3,7,6,3,3,C1,900
C,Uruguay,3,5,5,2,3,C2,900
C,Panama,3,4,2,3,-1,C3,900
C,Bolivia,3,0,2,7,-5,C4,900
D,Brazil,3,6,7,4,3,D1,900
D,Colombia,3,6,6,3,3,D2,900
D,Paraguay,3,4,3,4,-1,D3,900
D,Costa Rica,3,1,2,7,-5,D4,900
A,Argentina,3,7,5,3,2,A1,901
A,Chile,3,4,4,3,1,A2,901
A,Peru,3,3,5,5,0,A3,901
A,Canada,3,2,3,6,-3,A4,901
B,Mexico,3,5,3,2,1,B1,901
B,Venezuela,3,5,2,1,1,B2,901
B,Ecuador,3,4,3,3,0,B3,901
B,Jamaica,3,1,3,5,-2,B4,901
C,United States,3,7,4,2,2,C1,901
C,Uruguay,3,6,5,3,2,C2,901
C,Bolivia,3,2,1,3,-2,C3,901
C,Panama,3,1,1,3,-2,C4,901
D,Brazil,3,7,7,2,5,D1,901
D,Colombia,3,4,4,2,2,D2,901
D,Paraguay,3,4,3,4,-1,D3,901
D,Costa Rica,3,1,1,7,-6,D4,901
A,Argentina,3,9,8,0,8,A1,902
A,Chile,3,4,2,2,0,A2,902
A,Canada,3,2,0,3,-3,A3,902
A,Peru,3,1,0,5,-5,A4,902
B,Mexico,3,6,2,1,1,B1,902
B,Venezuela,3,4,4,3,1,B2,902
B,Ecuador,3,4,3,3,0,B3,902
B,Jamaica,3,3,1,3,-2,B4,902
C,United States,3,5,4,3,1,C1,902
C,Panama,3,4,6,6,0,C2,902
C,Bolivia,3,4,4,4,0,C3,902
C,Uruguay,3,3,4,5,-1,C4,902
D,Brazil,3,9,6,0,6,D1,902
D,Colombia,3,4,4,2,2,D2,902
D,Paraguay,3,3,1,7,-6,D3,902
D,Costa Rica,3,1,0,2,-2,D4,902
A,Argentina,3,9,7,2,5,A1,903
A,Canada,3,4,3,2,1,A2,903
A,Peru,3,4,2,3,-1,A3,903
A,Chile,3,0,2,7,-5,A4,903
B,Mexico,3,7,4,1,3,B1,903
B,Ecuador,3,4,2,1,1,B2,903
B,Venezuela,3,4,1,1,0,B3,903
B,Jamaica,3,1,1,5,-4,B4,903
C,Uruguay,3,7,5,3,2,C1,903
C,Panama,3,5,6,5,1,C2,903
C,United States,3,2,3,4,-1,C3,903
C,Bolivia,3,1,3,5,-2,C4,903
D,Brazil,3,9,5,1,4,D1,903
D,Colombia,3,6,4,3,1,D2,903
D,Paraguay,3,1,0,2,-2,D3,903
D,Costa Rica,3,1,0,3,-3,D4,903
A,Argentina,3,7,5,0,5,A1,904
A,Canada,3,4,2,3,-1,A2,904
A,Chile,3,4,2,4,-2,A3,904
A,Peru,3,1,0,2,-2,A4,904
B,Mexico,3,7,6,1,5,B1,904
B,Venezuela,3,4,3,1,2,B2,904
B,Ecuador,3,4,4,4,0,B3,904
B,Jamaica,3,1,0,7,-7,B4,904
C,United States,3,7,7,3,4,C1,904
C,Uruguay,3,6,6,2,4,C2,904
C,Bolivia,3,2,1,5,-4,C3,904
C,Panama,3,1,1,5,-4,C4,904
D,Brazil,3,7,3,1,2,D1,904
D,Paraguay,3,4,4,3,1,D2,904
D,Colombia,3,4,2,2,0,D3,904
D,Costa Rica,3,1,0,3,-3,D4,904
A,Argentina,3,9,5,0,5,A1,905
A,Peru,3,3,4,4,0,A2,905
A,Chile,3,3,3,5,-2,A3,905
A,Canada,3,3,3,6,-3,A4,905
B,Mexico,3,7,7,2,5,B1,905
B,Venezuela,3,4,3,4,-1,B2,905
B,Jamaica,3,3,4,6,-2,B3,905
B,Ecuador,3,2,2,4,-2,B4,905
C,United States,3,7,9,3,6,C1,905
C,Uruguay,3,5,3,2,1,C2,905
C,Panama,3,2,2,4,-2,C3,905
C,Bolivia,3,1,3,8,-5,C4,905
D,Costa Rica,3,9,7,0,7,D1,905
D,Brazil,3,3,3,3,0,D2,905
D,Colombia,3,3,3,4,-1,D3,905
D,Paraguay,3,3,2,8,-6,D4,905
A,Argentina,3,7,8,5,3,A1,906
A,Peru,3,6,6,4,2,A2,906
A,Canada,3,2,2,5,-3,A3,906
A,Chile,3,1,3,5,-2,A4,906
B,Venezuela,3,7,6,2,4,B1,906
B,Mexico,3,4,4,4,0,B2,906
B,Ecuador,3,3,4,6,-2,B3,906
B,Jamaica,3,3,3,5,-2,B4,906
C,United States,3,9,9,1,8,C1,906
C,Panama,3,6,2,2,0,C2,906
C,Uruguay,3,3,4,3,1,C3,906
C,Bolivia,3,0,0,9,-9,C4,906
D,Brazil,3,9,11,0,11,D1,906
D,Costa Rica,3,3,3,3,0,D2,906
D,Colombia,3,3,3,7,-4,D3,906
D,Paraguay,3,3,4,11,-7,D4,906
A,Argentina,3,7,6,3,3,A1,907
A,Chile,3,6,8,4,4,A2,907
A,Peru,3,2,2,5,-3,A3,907
A,Canada,3,1,4,8,-4,A4,907
B,Ecuador,3,9,8,4,4,B1,907
B,Mexico,3,6,7,5,2,B2,907
B,Jamaica,3,1,4,7,-3,B3,907
B,Venezuela,3,1,0,3,-3,B4,907
C,Uruguay,3,9,8,0,8,C1,907
C,Bolivia,3,4,2,4,-2,C2,907
C,United States,3,3,3,5,-2,C3,907
C,Panama,3,1,1,5,-4,C4,907
D,Brazil,3,7,10,2,8,D1,907
D,Paraguay,3,6,2,3,-1,D2,907
D,Colombia,3,4,5,3,2,D3,907
D,Costa Rica,3,0,0,9,-9,D4,907
A,Argentina,3,9,5,2,3,A1,908
A,Chile,3,6,4,3,1,A2,908
A,Canada,3,3,7,6,1,A3,908
A,Peru,3,0,4,9,-5,A4,908
B,Mexico,3,7,4,1,3,B1,908
B,Venezuela,3,4,1,2,-1,B2,908
B,Jamaica,3,3,1,1,0,B3,908
B,Ecuador,3,1,2,4,-2,B4,908
C,Bolivia,3,7,5,2,3,C1,908
C,Uruguay,3,6,9,2,7,C2,908
C,Panama,3,3,2,6,-4,C3,908
C,United States,3,1,2,8,-6,C4,908
D,Brazil,3,6,8,2,6,D1,908
D,Colombia,3,6,4,3,1,D2,908
D,Costa Rica,3,6,4,3,1,D3,908
D,Paraguay,3,0,1,9,-8,D4,908
A,Chile,3,7,4,1,3,A1,909
A,Argentina,3,5,4,2,2,A2,909
A,Peru,3,2,2,3,-1,A3,909
A,Canada,3,1,1,5,-4,A4,909
B,Ecuador,3,6,9,4,5,B1,909
B,Mexico,3,6,7,6,1,B2,909
B,Venezuela,3,3,4,7,-3,B3,909
B,Jamaica,3,3,2,5,-3,B4,909
C,United States,3,7,10,2,8,C1,909
C,Uruguay,3,7,5,2,3,C2,909
C,Panama,3,3,4,4,0,C3,909
C,Bolivia,3,0,0,11,-11,C4,909
D,Brazil,3,6,7,5,2,D1,909
D,Costa Rica,3,6,3,3,0,D2,909
D,Colombia,3,3,6,5,1,D3,909
D,Paraguay,3,3,3,6,-3,D4,909
A,Argentina,3,6,6,3,3,A1,910
A,Peru,3,4,4,4,0,A2,910
A,Canada,3,4,1,2,-1,A3,910
A,Chile,3,2,4,6,-2,A4,910
B,Venezuela,3,5,6,2,4,B1,910
B,Ecuador,3,4,5,2,3,B2,910
B,Mexico,3,4,2,5,-3,B3,910
B,Jamaica,3,2,2,6,-4,B4,910
C,Uruguay,3,9,8,3,5,C1,910
C,United States,3,6,10,3,7,C2,910
C,Panama,3,3,2,5,-3,C3,910
C,Bolivia,3,0,2,11,-9,C4,910
D,Colombia,3,9,6,0,6,D1,910
D,Brazil,3,4,3,4,-1,D2,910
D,Costa Rica,3,3,3,5,-2,D3,910
D,Paraguay,3,1,2,5,-3,D4,910
A,Chile,3,5,5,1,4,A1,911
A,Argentina,3,5,3,2,1,A2,911
A,Peru,3,3,1,1,0,A3,911
A,Canada,3,1,2,7,-5,A4,911
B,Mexico,3,7,6,1,5,B1,911
B,Venezuela,3,4,2,3,-1,B2,911
B,Jamaica,3,3,1,1,0,B3,911
B,Ecuador,3,1,1,5,-4,B4,911
C,United States,3,7,5,1,4,C1,911
C,Uruguay,3,6,7,1,6,C2,911
C,Panama,3,2,1,5,-4,C3,911
C,Bolivia,3,1,0,6,-6,C4,911
D,Brazil,3,5,4,2,2,D1,911
D,Colombia,3,5,4,3,1,D2,911
D,Costa Rica,3,3,1,1,0,D3,911
D,Paraguay,3,1,2,5,-3,D4,911
A,Argentina,3,7,6,1,5,A1,912
A,Chile,3,4,3,3,0,A2,912
A,Canada,3,2,2,3,-1,A3,912
A,Peru,3,2,1,5,-4,A4,912
B,Ecuador,3,7,3,0,3,B1,912
B,Venezuela,3,7,2,0,2,B2,912
B,Mexico,3,3,2,4,-2,B3,912
B,Jamaica,3,0,1,4,-3,B4,912
C,United States,3,9,5,2,3,C1,912
C,Uruguay,3,4,7,4,3,C2,912
C,Panama,3,3,3,7,-4,C3,912
C,Bolivia,3,1,5,7,-2,C4,912
D,Brazil,3,9,6,0,6,D1,912
D,Colombia,3,4,3,3,0,D2,912
D,Costa Rica,3,3,2,4,-2,D3,912
D,Paraguay,3,1,0,4,-4,D4,912
A,Argentina,3,9,11,3,8,A1,913
A,Peru,3,6,7,4,3,A2,913
A,Chile,3,1,2,6,-4,A3,913
A,Canada,3,1,2,9,-7,A4,913
B,Mexico,3,7,8,5,3,B1,913
B,Venezuela,3,5,4,2,2,B2,913
B,Ecuador,3,3,3,5,-2,B3,913
B,Jamaica,3,1,2,5,-3,B4,913
C,Uruguay,3,9,7,1,6,C1,913
C,Panama,3,6,7,6,1,C2,913
C,United States,3,1,2,4,-2,C3,913
C,Bolivia,3,1,4,9,-5,C4,913
D,Brazil,3,9,5,0,5,D1,913
D,Colombia,3,6,4,1,3,D2,913
D,Paraguay,3,3,2,6,-4,D3,913
D,Costa Rica,3,0,1,5,-4,D4,913
A,Chile,3,7,10,2,8,A1,914
A,Argentina,3,5,4,3,1,A2,914
A,Peru,3,2,2,4,-2,A3,914
A,Canada,3,1,1,8,-7,A4,914
B,Jamaica,3,4,3,3,0,B1,914
B,Ecuador,3,4,2,2,0,B2,914
B,Mexico,3,4,2,2,0,B3,914
B,Venezuela,3,3,0,0,0,B4,914
C,United States,3,7,6,4,2,C1,914
C,Uruguay,3,6,8,2,6,C2,914
C,Bolivia,3,3,4,7,-3,C3,914
C,Panama,3,1,2,7,-5,C4,914
D,Brazil,3,6,4,2,2,D1,914
D,Colombia,3,6,2,1,1,D2,914
D,Paraguay,3,4,2,2,0,D3,914
D,Costa Rica,3,1,2,5,-3,D4,914
A,Argentina,3,6,8,4,4,A1,915
A,Canada,3,6,5,4,1,A2,915
A,Chile,3,6,4,4,0,A3,915
A,Peru,3,0,1,6,-5,A4,915
B,Mexico,3,9,9,3,6,B1,915
B,Ecuador,3,4,5,5,0,B2,915
B,Venezuela,3,3,3,5,-2,B3,915
B,Jamaica,3,1,5,9,-4,B4,915
C,Uruguay,3,6,6,2,4,C1,915
C,United States,3,6,4,2,2,C2,915
C,Bolivia,3,6,4,5,-1,C3,915
C,Panama,3,0,1,6,-5,C4,915
D,Brazil,3,7,4,2,2,D1,915
D,Paraguay,3,5,5,3,2,D2,915
D,Costa Rica,3,2,1,2,-1,D3,915
D,Colombia,3,1,0,3,-3,D4,915
A,Argentina,3,6,4,2,2,A1,916
A,Peru,3,4,3,2,1,A2,916
A,Chile,3,4,1,3,-2,A3,916
A,Canada,3,2,1,2,-1,A4,916
B,Mexico,3,7,8,3,5,B1,916
B,Venezuela,3,4,3,4,-1,B2,916
B,Ecuador,3,3,3,5,-2,B3,916
B,Jamaica,3,3,3,5,-2,B4,916
C,Uruguay,3,9,7,3,4,C1,916
C,United States,3,4,5,4,1,C2,916
C,Bolivia,3,3,3,4,-1,C3,916
C,Panama,3,1,3,7,-4,C4,916
D,Colombia,3,9,5,0,5,D1,916
D,Brazil,3,6,10,1,9,D2,916
D,Costa Rica,3,3,2,9,-7,D3,916
D,Paraguay,3,0,1,8,-7,D4,916
A,Chile,3,7,6,1,5,A1,917
A,Argentina,3,4,6,5,1,A2,917
A,Canada,3,4,5,7,-2,A3,917
A,Peru,3,1,2,6,-4,A4,917
B,Mexico,3,6,8,4,4,B1,917
B,Venezuela,3,6,6,2,4,B2,917
B,Ecuador,3,6,4,3,1,B3,917
B,Jamaica,3,0,0,9,-9,B4,917
C,United States,3,9,8,1,7,C1,917
C,Uruguay,3,4,1,2,-1,C2,917
C,Panama,3,2,1,4,-3,C3,917
C,Bolivia,3,1,2,5,-3,C4,917
D,Brazil,3,5,2,1,1,D1,917
D,Costa Rica,3,4,3,2,1,D2,917
D,Colombia,3,4,2,2,0,D3,917
D,Paraguay,3,3,1,3,-2,D4,917
A,Argentina,3,7,10,4,6,A1,918
A,Peru,3,4,3,3,0,A2,918
A,Chile,3,3,6,7,-1,A3,918
A,Canada,3,3,2,7,-5,A4,918
B,Mexico,3,6,4,4,0,B1,918
B,Venezuela,3,4,4,3,1,B2,918
B,Ecuador,3,4,3,4,-1,B3,918
B,Jamaica,3,3,4,4,0,B4,918
C,Uruguay,3,9,13,1,12,C1,918
C,United States,3,6,6,4,2,C2,918
C,Panama,3,3,2,10,-8,C3,918
C,Bolivia,3,0,1,7,-6,C4,918
D,Brazil,3,6,5,4,1,D1,918
D,Paraguay,3,4,6,6,0,D2,918
D,Costa Rica,3,4,4,4,0,D3,918
D,Colombia,3,2,3,4,-1,D4,918
A,Argentina,3,9,7,0,7,A1,919
A,Peru,3,6,3,1,2,A2,919
A,Chile,3,3,4,4,0,A3,919
A,Canada,3,0,0,9,-9,A4,919
B,Jamaica,3,6,3,4,-1,B1,919
B,Venezuela,3,4,7,5,2,B2,919
B,Mexico,3,4,4,3,1,B3,919
B,Ecuador,3,2,3,5,-2,B4,919
C,United States,3,7,5,1,4,C1,919
C,Uruguay,3,7,5,1,4,C2,919
C,Bolivia,3,3,3,5,-2,C3,919
C,Panama,3,0,1,7,-6,C4,919
D,Brazil,3,9,10,2,8,D1,919
D,Paraguay,3,6,4,4,0,D2,919
D,Colombia,3,3,3,4,-1,D3,919
D,Costa Rica,3,0,1,8,-7,D4,919
A,Argentina,3,7,7,3,4,A1,920
A,Canada,3,6,4,5,-1,A2,920
A,Peru,3,2,4,5,-1,A3,920
A,Chile,3,1,3,5,-2,A4,920
B,Mexico,3,6,5,1,4,B1,920
B,Ecuador,3,6,5,2,3,B2,920
B,Venezuela,3,3,3,6,-3,B3,920
B,Jamaica,3,3,2,6,-4,B4,920
C,United States,3,5,4,2,2,C1,920
C,Uruguay,3,4,5,2,3,C2,920
C,Bolivia,3,4,2,2,0,C3,920
C,Panama,3,3,1,6,-5,C4,920
D,Brazil,3,4,6,4,2,D1,920
D,Paraguay,3,4,5,6,-1,D2,920
D,Costa Rica,3,4,2,3,-1,D3,920
D,Colombia,3,3,1,1,0,D4,920
A,Argentina,3,7,5,0,5,A1,921
A,Peru,3,5,4,1,3,A2,921
A,Chile,3,2,2,4,-2,A3,921
A,Canada,3,1,1,7,-6,A4,921
B,Ecuador,3,7,4,1,3,B1,921
B,Mexico,3,7,2,0,2,B2,921
B,Venezuela,3,3,2,4,-2,B3,921
B,Jamaica,3,0,2,5,-3,B4,921
C,Uruguay,3,9,4,0,4,C1,921
C,United States,3,6,5,3,2,C2,921
C,Bolivia,3,3,3,3,0,C3,921
C,Panama,3,0,0,6,-6,C4,921
D,Colombia,3,7,3,1,2,D1,921
D,Paraguay,3,4,2,2,0,D2,921
D,Brazil,3,3,2,2,0,D3,921
D,Costa Rica,3,1,2,4,-2,D4,921
A,Chile,3,6,7,6,1,A1,922
A,Argentina,3,5,6,4,2,A2,922
A,Peru,3,4,3,4,-1,A3,922
A,Canada,3,1,4,6,-2,A4,922
B,Mexico,3,9,5,0,5,B1,922
B,Venezuela,3,4,5,4,1,B2,922
B,Ecuador,3,2,3,5,-2,B3,922
B,Jamaica,3,1,1,5,-4,B4,922
C,Panama,3,5,4,2,2,C1,922
C,United States,3,5,4,2,2,C2,922
C,Bolivia,3,2,2,4,-2,C3,922
C,Uruguay,3,2,2,4,-2,C4,922
D,Colombia,3,7,8,2,6,D1,922
D,Brazil,3,5,5,3,2,D2,922
D,Costa Rica,3,3,4,10,-6,D3,922
D,Paraguay,3,1,4,6,-2,D4,922
A,Argentina,3,7,6,3,3,A1,923
A,Chile,3,4,6,6,0,A2,923
A,Canada,3,3,5,5,0,A3,923
A,Peru,3,2,4,7,-3,A4,923
B,Mexico,3,5,7,4,3,B1,923
B,Jamaica,3,3,4,4,0,B2,923
B,Venezuela,3,3,2,2,0,B3,923
B,Ecuador,3,2,0,3,-3,B4,923
C,Uruguay,3,7,6,1,5,C1,923
C,United States,3,5,4,3,1,C2,923
C,Bolivia,3,4,4,4,0,C3,923
C,Panama,3,0,2,8,-6,C4,923
D,Brazil,3,9,8,0,8,D1,923
D,Colombia,3,6,4,4,0,D2,923
D,Paraguay,3,3,4,5,-1,D3,923
D,Costa Rica,3,0,0,7,-7,D4,923
A,Peru,3,7,7,4,3,A1,924
A,Argentina,3,6,10,3,7,A2,924
A,Canada,3,4,5,8,-3,A3,924
A,Chile,3,0,1,8,-7,A4,924
B,Mexico,3,7,3,1,2,B1,924
B,Ecuador,3,4,4,3,1,B2,924
B,Venezuela,3,3,3,5,-2,B3,924
B,Jamaica,3,2,1,2,-1,B4,924
C,Panama,3,7,5,2,3,C1,924
C,Bolivia,3,6,2,1,1,C2,924
C,United States,3,4,3,2,1,C3,924
C,Uruguay,3,0,1,6,-5,C4,924
D,Brazil,3,7,7,2,5,D1,924
D,Colombia,3,5,3,1,2,D2,924
D,Paraguay,3,3,1,6,-5,D3,924
D,Costa Rica,3,1,1,3,-2,D4,924
A,Argentina,3,9,4,1,3,A1,925
A,Peru,3,6,8,2,6,A2,925
A,Chile,3,3,3,6,-3,A3,925
A,Canada,3,0,2,8,-6,A4,925
B,Mexico,3,9,8,1,7,B1,925
B,Venezuela,3,6,4,3,1,B2,925
B,Ecuador,3,3,3,6,-3,B3,925
B,Jamaica,3,0,0,5,-5,B4,925
C,United States,3,6,7,4,3,C1,925
C,Bolivia,3,6,7,6,1,C2,925
C,Uruguay,3,6,4,3,1,C3,925
C,Panama,3,0,4,9,-5,C4,925
D,Brazil,3,9,9,2,7,D1,925
D,Paraguay,3,6,4,6,-2,D2,925
D,Costa Rica,3,3,2,4,-2,D3,925
D,Colombia,3,0,1,4,-3,D4,925
A,Peru,3,7,3,1,2,A1,926
A,Argentina,3,6,6,3,3,A2,926
A,Chile,3,4,2,4,-2,A3,926
A,Canada,3,0,2,5,-3,A4,926
B,Ecuador,3,7,3,0,3,B1,926
B,Jamaica,3,3,2,2,0,B2,926
B,Mexico,3,2,1,2,-1,B3,926
B,Venezuela,3,2,1,3,-2,B4,926
C,Uruguay,3,7,6,1,5,C1,926
C,United States,3,4,4,4,0,C2,926
C,Bolivia,3,4,2,5,-3,C3,926
C,Panama,3,1,2,4,-2,C4,926
D,Colombia,3,6,4,3,1,D1,926
D,Brazil,3,4,6,4,2,D2,926
D,Costa Rica,3,4,2,4,-2,D3,926
D,Paraguay,3,2,2,3,-1,D4,926
A,Argentina,3,9,7,0,7,A1,927
A,Peru,3,6,5,3,2,A2,927
A,Chile,3,3,3,5,-2,A3,927
A,Canada,3,0,1,8,-7,A4,927
B,Ecuador,3,5,3,0,3,B1,927
B,Venezuela,3,5,3,2,1,B2,927
B,Mexico,3,3,4,4,0,B3,927
B,Jamaica,3,1,2,6,-4,B4,927
C,Uruguay,3,9,8,1,7,C1,927
C,United States,3,6,8,4,4,C2,927
C,Bolivia,3,1,1,6,-5,C3,927
C,Panama,3,1,1,7,-6,C4,927
D,Brazil,3,6,6,2,4,D1,927
D,Paraguay,3,4,3,4,-1,D2,927
D,Colombia,3,4,2,3,-1,D3,927
D,Costa Rica,3,3,2,4,-2,D4,927
A,Chile,3,6,8,4,4,A1,928
A,Peru,3,6,4,3,1,A2,928
A,Canada,3,3,6,8,-2,A3,928
A,Argentina,3,3,2,5,-3,A4,928
B,Mexico,3,7,4,2,2,B1,928
B,Jamaica,3,4,3,3,0,B2,928
B,Ecuador,3,4,2,2,0,B3,928
B,Venezuela,3,1,1,3,-2,B4,928
C,Panama,3,5,6,3,3,C1,928
C,Uruguay,3,5,3,2,1,C2,928
C,United States,3,3,8,5,3,C3,928
C,Bolivia,3,2,2,9,-7,C4,928
D,Brazil,3,9,8,2,6,D1,928
D,Paraguay,3,4,4,4,0,D2,928
D,Colombia,3,2,1,2,-1,D3,928
D,Costa Rica,3,1,0,5,-5,D4,928
A,Chile,3,7,6,1,5,A1,929
A,Argentina,3,7,6,2,4,A2,929
A,Peru,3,1,1,5,-4,A3,929
A,Canada,3,1,2,7,-5,A4,929
B,Mexico,3,6,5,2,3,B1,929
B,Venezuela,3,6,3,3,0,B2,929
B,Ecuador,3,4,2,2,0,B3,929
B,Jamaica,3,1,1,4,-3,B4,929
C,Uruguay,3,7,6,3,3,C1,929
C,United States,3,6,6,3,3,C2,929
C,Panama,3,2,4,7,-3,C3,929
C,Bolivia,3,1,3,6,-3,C4,929
D,Brazil,3,7,6,2,4,D1,929
D,Colombia,3,5,5,3,2,D2,929
D,Costa Rica,3,4,3,3,0,D3,929
D,Paraguay,3,0,1,7,-6,D4,929
A,Argentina,3,6,5,1,4,A1,930
A,Peru,3,6,4,3,1,A2,930
A,Chile,3,6,3,2,1,A3,930
A,Canada,3,0,0,6,-6,A4,930
B,Ecuador,3,6,8,3,5,B1,930
B,Venezuela,3,4,2,2,0,B2,930
B,Mexico,3,4,2,6,-4,B3,930
B,Jamaica,3,3,3,4,-1,B4,930
C,Panama,3,5,2,1,1,C1,930
C,United States,3,5,2,1,1,C2,930
C,Uruguay,3,4,3,3,0,C3,930
C,Bolivia,3,1,2,4,-2,C4,930
D,Costa Rica,3,6,4,4,0,D1,930
D,Brazil,3,4,6,4,2,D2,930
D,Colombia,3,4,2,1,1,D3,930
D,Paraguay,3,3,3,6,-3,D4,930
A,Argentina,3,7,5,2,3,A1,931
A,Peru,3,4,3,3,0,A2,931
A,Canada,3,3,2,4,-2,A3,931
A,Chile,3,2,1,2,-1,A4,931
B,Mexico,3,5,4,1,3,B1,931
B,Venezuela,3,4,4,5,-1,B2,931
B,Ecuador,3,3,1,1,0,B3,931
B,Jamaica,3,2,2,4,-2,B4,931
C,Uruguay,3,7,7,3,4,C1,931
C,United States,3,6,6,3,3,C2,931
C,Panama,3,3,2,5,-3,C3,931
C,Bolivia,3,1,0,4,-4,C4,931
D,Brazil,3,7,4,1,3,D1,931
D,Colombia,3,7,5,3,2,D2,931
D,Paraguay,3,3,3,4,-1,D3,931
D,Costa Rica,3,0,1,5,-4,D4,931
A,Peru,3,5,4,3,1,A1,932
A,Argentina,3,5,3,2,1,A2,932
A,Chile,3,4,4,4,0,A3,932
A,Canada,3,1,2,4,-2,A4,932
B,Venezuela,3,6,7,2,5,B1,932
B,Mexico,3,6,3,2,1,B2,932
B,Ecuador,3,4,2,3,-1,B3,932
B,Jamaica,3,1,3,8,-5,B4,932
C,United States,3,9,7,2,5,C1,932
C,Uruguay,3,4,6,5,1,C2,932
C,Bolivia,3,3,1,3,-2,C3,932
C,Panama,3,1,2,6,-4,C4,932
D,Brazil,3,6,5,2,3,D1,932
D,Colombia,3,6,4,3,1,D2,932
D,Paraguay,3,3,1,2,-1,D3,932
D,Costa Rica,3,3,3,6,-3,D4,932
A,Argentina,3,7,6,2,4,A1,933
A,Canada,3,6,3,2,1,A2,933
A,Chile,3,4,3,3,0,A3,933
A,Peru,3,0,1,6,-5,A4,933
B,Mexico,3,5,5,3,2,B1,933
B,Jamaica,3,5,3,2,1,B2,933
B,Ecuador,3,2,2,3,-1,B3,933
B,Venezuela,3,2,3,5,-2,B4,933
C,Uruguay,3,5,6,3,3,C1,933
C,United States,3,5,5,4,1,C2,933
C,Panama,3,3,4,4,0,C3,933
C,Bolivia,3,1,3,7,-4,C4,933
D,Brazil,3,9,11,1,10,D1,933
D,Paraguay,3,4,2,5,-3,D2,933
D,Colombia,3,3,3,3,0,D3,933
D,Costa Rica,3,1,1,8,-7,D4,933
A,Argentina,3,6,9,2,7,A1,934
A,Chile,3,5,3,2,1,A2,934
A,Peru,3,4,4,3,1,A3,934
A,Canada,3,1,0,9,-9,A4,934
B,Ecuador,3,7,5,2,3,B1,934
B,Venezuela,3,4,4,4,0,B2,934
B,Jamaica,3,4,3,3,0,B3,934
B,Mexico,3,1,1,4,-3,B4,934
C,Uruguay,3,7,10,3,7,C1,934
C,United States,3,7,5,2,3,C2,934
C,Panama,3,3,4,5,-1,C3,934
C,Bolivia,3,0,1,10,-9,C4,934
D,Colombia,3,7,6,1,5,D1,934
D,Brazil,3,5,5,2,3,D2,934
D,Paraguay,3,4,3,5,-2,D3,934
D,Costa Rica,3,0,2,8,-6,D4,934
A,Canada,3,7,5,3,2,A1,935
A,Argentina,3,6,6,5,1,A2,935
A,Chile,3,4,3,3,0,A3,935
A,Peru,3,0,3,6,-3,A4,935
B,Ecuador,3,7,6,2,4,B1,935
B,Jamaica,3,6,3,3,0,B2,935
B,Venezuela,3,3,2,4,-2,B3,935
B,Mexico,3,1,2,4,-2,B4,935
C,Uruguay,3,7,4,1,3,C1,935
C,United States,3,7,3,0,3,C2,935
C,Panama,3,3,2,2,0,C3,935
C,Bolivia,3,0,1,7,-6,C4,935
D,Brazil,3,7,5,1,4,D1,935
D,Costa Rica,3,6,3,2,1,D2,935
D,Colombia,3,2,2,3,-1,D3,935
D,Paraguay,3,1,2,6,-4,D4,935
A,Argentina,3,6,8,2,6,A1,936
A,Chile,3,6,5,3,2,A2,936
A,Peru,3,3,5,7,-2,A3,936
A,Canada,3,3,4,10,-6,A4,936
B,Venezuela,3,7,7,2,5,B1,936
B,Ecuador,3,5,6,3,3,B2,936
B,Mexico,3,4,6,8,-2,B3,936
B,Jamaica,3,0,1,7,-6,B4,936
C,United States,3,7,5,3,2,C1,936
C,Uruguay,3,4,6,5,1,C2,936
C,Bolivia,3,4,4,4,0,C3,936
C,Panama,3,1,3,6,-3,C4,936
D,Brazil,3,7,6,2,4,D1,936
D,Colombia,3,6,7,4,3,D2,936
D,Costa Rica,3,2,2,4,-2,D3,936
D,Paraguay,3,1,2,7,-5,D4,936
A,Argentina,3,6,7,5,2,A1,937
A,Peru,3,4,4,3,1,A2,937
A,Chile,3,4,2,4,-2,A3,937
A,Canada,3,3,5,6,-1,A4,937
B,Ecuador,3,7,6,3,3,B1,937
B,Mexico,3,5,7,5,2,B2,937
B,Venezuela,3,3,6,5,1,B3,937
B,Jamaica,3,1,4,10,-6,B4,937
C,United States,3,7,4,0,4,C1,937
C,Uruguay,3,7,4,1,3,C2,937
C,Panama,3,3,3,5,-2,C3,937
C,Bolivia,3,0,2,7,-5,C4,937
D,Brazil,3,9,8,1,7,D1,937
D,Colombia,3,6,5,4,1,D2,937
D,Costa Rica,3,1,3,6,-3,D3,937
D,Paraguay,3,1,2,7,-5,D4,937
A,Canada,3,7,4,2,2,A1,938
A,Argentina,3,6,5,2,3,A2,938
A,Chile,3,2,3,6,-3,A3,938
A,Peru,3,1,2,4,-2,A4,938
B,Ecuador,3,7,4,1,3,B1,938
B,Venezuela,3,5,4,0,4,B2,938
B,Mexico,3,4,4,2,2,B3,938
B,Jamaica,3,0,0,9,-9,B4,938
C,Uruguay,3,7,10,2,8,C1,938
C,United States,3,6,6,6,0,C2,938
C,Bolivia,3,2,1,4,-3,C3,938
C,Panama,3,1,1,6,-5,C4,938
D,Colombia,3,5,5,2,3,D1,938
D,Brazil,3,5,4,1,3,D2,938
D,Costa Rica,3,2,3,6,-3,D3,938
D,Paraguay,3,2,0,3,-3,D4,938
A,Peru,3,9,7,3,4,A1,939
A,Canada,3,4,5,6,-1,A2,939
A,Chile,3,2,1,2,-1,A3,939
A,Argentina,3,1,2,4,-2,A4,939
B,Ecuador,3,6,7,2,5,B1,939
B,Venezuela,3,4,3,4,-1,B2,939
B,Mexico,3,4,3,6,-3,B3,939
B,Jamaica,3,2,2,3,-1,B4,939
C,United States,3,9,5,1,4,C1,939
C,Uruguay,3,6,4,2,2,C2,939
C,Bolivia,3,3,2,5,-3,C3,939
C,Panama,3,0,1,4,-3,C4,939
D,Colombia,3,5,5,3,2,D1,939
D,Brazil,3,4,7,6,1,D2,939
D,Paraguay,3,4,3,3,0,D3,939
D,Costa Rica,3,3,2,5,-3,D4,939
A,Canada,3,6,5,3,2,A1,940
A,Chile,3,4,3,3,0,A2,940
A,Peru,3,4,2,3,-1,A3,940
A,Argentina,3,2,1,2,-1,A4,940
B,Ecuador,3,7,5,2,3,B1,940
B,Mexico,3,5,5,2,3,B2,940
B,Jamaica,3,4,4,4,0,B3,940
B,Venezuela,3,0,3,9,-6,B4,940
C,United States,3,9,8,2,6,C1,940
C,Panama,3,4,4,6,-2,C2,940
C,Uruguay,3,2,3,4,-1,C3,940
C,Bolivia,3,1,2,5,-3,C4,940
D,Brazil,3,9,5,1,4,D1,940
D,Costa Rica,3,4,3,4,-1,D2,940
D,Paraguay,3,2,2,3,-1,D3,940
D,Colombia,3,1,3,5,-2,D4,940
A,Chile,3,6,4,2,2,A1,941
A,Argentina,3,5,1,0,1,A2,941
A,Canada,3,4,3,1,2,A3,941
A,Peru,3,1,1,6,-5,A4,941
B,Mexico,3,7,5,2,3,B1,941
B,Ecuador,3,6,5,3,2,B2,941
B,Venezuela,3,4,2,2,0,B3,941
B,Jamaica,3,0,0,5,-5,B4,941
C,Uruguay,3,7,8,4,4,C1,941
C,United States,3,4,7,7,0,C2,941
C,Panama,3,3,4,4,0,C3,941
C,Bolivia,3,1,2,6,-4,C4,941
D,Colombia,3,9,5,0,5,D1,941
D,Brazil,3,4,3,2,1,D2,941
D,Costa Rica,3,2,3,6,-3,D3,941
D,Paraguay,3,1,2,5,-3,D4,941
A,Argentina,3,9,9,1,8,A1,942
A,Canada,3,6,5,4,1,A2,942
A,Chile,3,3,1,4,-3,A3,942
A,Peru,3,0,0,6,-6,A4,942
B,Mexico,3,9,6,2,4,B1,942
B,Jamaica,3,3,7,7,0,B2,942
B,Venezuela,3,3,4,5,-1,B3,942
B,Ecuador,3,3,3,6,-3,B4,942
C,Uruguay,3,7,8,5,3,C1,942
C,Panama,3,3,2,2,0,C2,942
C,United States,3,2,5,6,-1,C3,942
C,Bolivia,3,2,4,6,-2,C4,942
D,Costa Rica,3,7,5,2,3,D1,942
D,Brazil,3,5,8,3,5,D2,942
D,Colombia,3,4,2,3,-1,D3,942
D,Paraguay,3,0,2,9,-7,D4,942
A,Argentina,3,6,5,2,3,A1,943
A,Peru,3,6,3,2,1,A2,943
A,Canada,3,3,2,3,-1,A3,943
A,Chile,3,3,4,7,-3,A4,943
B,Mexico,3,7,5,2,3,B1,943
B,Ecuador,3,6,5,4,1,B2,943
B,Jamaica,3,2,4,5,-1,B3,943
B,Venezuela,3,1,2,5,-3,B4,943
C,United States,3,7,7,4,3,C1,943
C,Uruguay,3,6,4,3,1,C2,943
C,Bolivia,3,3,3,5,-2,C3,943
C,Panama,3,1,2,4,-2,C4,943
D,Colombia,3,9,6,2,4,D1,943
D,Brazil,3,6,4,3,1,D2,943
D,Paraguay,3,3,1,3,-2,D3,943
D,Costa Rica,3,0,0,3,-3,D4,943
A,Argentina,3,7,10,2,8,A1,944
A,Peru,3,4,4,4,0,A2,944
A,Canada,3,4,4,9,-5,A3,944
A,Chile,3,1,3,6,-3,A4,944
B,Ecuador,3,7,7,1,6,B1,944
B,Mexico,3,5,2,1,1,B2,944
B,Venezuela,3,3,3,2,1,B3,944
B,Jamaica,3,1,0,8,-8,B4,944
C,United States,3,7,5,2,3,C1,944
C,Bolivia,3,4,2,3,-1,C2,944
C,Panama,3,3,3,3,0,C3,944
C,Uruguay,3,1,2,4,-2,C4,944
D,Colombia,3,7,6,3,3,D1,944
D,Brazil,3,4,9,5,4,D2,944
D,Paraguay,3,3,4,6,-2,D3,944
D,Costa Rica,3,3,1,6,-5,D4,944
A,Chile,3,7,3,1,2,A1,945
A,Peru,3,4,4,2,2,A2,945
A,Argentina,3,4,2,1,1,A3,945
A,Canada,3,1,0,5,-5,A4,945
B,Ecuador,3,7,7,3,4,B1,945
B,Mexico,3,4,7,7,0,B2,945
B,Venezuela,3,4,5,6,-1,B3,945
B,Jamaica,3,1,3,6,-3,B4,945
C,United States,3,7,5,0,5,C1,945
C,Uruguay,3,6,6,3,3,C2,945
C,Panama,3,2,2,4,-2,C3,945
C,Bolivia,3,1,3,9,-6,C4,945
D,Colombia,3,7,4,1,3,D1,945
D,Brazil,3,7,3,1,2,D2,945
D,Costa Rica,3,3,2,4,-2,D3,945
D,Paraguay,3,0,1,4,-3,D4,945
A,Argentina,3,5,3,1,2,A1,946
A,Peru,3,5,2,0,2,A2,946
A,Canada,3,4,3,3,0,A3,946
A,Chile,3,1,0,4,-4,A4,946
B,Mexico,3,9,7,1,6,B1,946
B,Venezuela,3,4,2,2,0,B2,946
B,Ecuador,3,3,3,4,-1,B3,946
B,Jamaica,3,1,1,6,-5,B4,946
C,Bolivia,3,6,6,6,0,C1,946
C,United States,3,4,8,6,2,C2,946
C,Uruguay,3,4,6,4,2,C3,946
C,Panama,3,3,4,8,-4,C4,946
D,Brazil,3,9,6,1,5,D1,946
D,Paraguay,3,4,4,4,0,D2,946
D,Colombia,3,2,3,4,-1,D3,946
D,Costa Rica,3,1,4,8,-4,D4,946
A,Chile,3,6,3,2,1,A1,947
A,Peru,3,4,4,3,1,A2,947
A,Argentina,3,4,2,3,-1,A3,947
A,Canada,3,2,3,4,-1,A4,947
B,Ecuador,3,5,6,3,3,B1,947
B,Venezuela,3,4,5,4,1,B2,947
B,Jamaica,3,4,5,6,-1,B3,947
B,Mexico,3,3,2,5,-3,B4,947
C,United States,3,6,7,3,4,C1,947
C,Uruguay,3,4,3,3,0,C2,947
C,Bolivia,3,4,2,3,-1,C3,947
C,Panama,3,2,1,4,-3,C4,947
D,Brazil,3,7,7,2,5,D1,947
D,Colombia,3,7,5,1,4,D2,947
D,Paraguay,3,1,1,4,-3,D3,947
D,Costa Rica,3,1,2,8,-6,D4,947
A,Argentina,3,7,6,2,4,A1,948
A,Peru,3,4,4,2,2,A2,948
A,Chile,3,3,1,6,-5,A3,948
A,Canada,3,2,3,4,-1,A4,948
B,Venezuela,3,7,5,2,3,B1,948
B,Jamaica,3,5,2,1,1,B2,948
B,Mexico,3,3,3,5,-2,B3,948
B,Ecuador,3,1,3,5,-2,B4,948
C,Uruguay,3,9,6,0,6,C1,948
C,United States,3,6,7,3,4,C2,948
C,Panama,3,3,5,7,-2,C3,948
C,Bolivia,3,0,3,11,-8,C4,948
D,Brazil,3,9,13,2,11,D1,948
D,Colombia,3,4,3,7,-4,D2,948
D,Paraguay,3,3,4,4,0,D3,948
D,Costa Rica,3,1,0,7,-7,D4,948
A,Canada,3,5,6,5,1,A1,949
A,Chile,3,4,5,5,0,A2,949
A,Argentina,3,4,3,3,0,A3,949
A,Peru,3,3,4,5,-1,A4,949
B,Mexico,3,5,5,3,2,B1,949
B,Ecuador,3,5,4,2,2,B2,949
B,Venezuela,3,4,3,4,-1,B3,949
B,Jamaica,3,1,1,4,-3,B4,949
C,Uruguay,3,6,5,4,1,C1,949
C,United States,3,4,5,4,1,C2,949
C,Bolivia,3,4,3,3,0,C3,949
C,Panama,3,3,3,5,-2,C4,949
D,Brazil,3,6,8,2,6,D1,949
D,Costa Rica,3,6,5,7,-2,D2,949
D,Colombia,3,4,2,2,0,D3,949
D,Paraguay,3,1,0,4,-4,D4,949
A,Argentina,3,7,5,2,3,A1,950
A,Chile,3,6,3,2,1,A2,950
A,Peru,3,3,2,4,-2,A3,950
A,Canada,3,1,2,4,-2,A4,950
B,Ecuador,3,6,4,2,2,B1,950
B,Mexico,3,6,5,4,1,B2,950
B,Jamaica,3,3,4,5,-1,B3,950
B,Venezuela,3,3,2,4,-2,B4,950
C,United States,3,4,4,4,0,C1,950
C,Bolivia,3,4,2,2,0,C2,950
C,Panama,3,4,2,2,0,C3,950
C,Uruguay,3,4,2,2,0,C4,950
D,Brazil,3,9,10,1,9,D1,950
D,Costa Rica,3,6,3,7,-4,D2,950
D,Colombia,3,1,1,3,-2,D3,950
D,Paraguay,3,1,1,4,-3,D4,950
A,Argentina,3,9,8,0,8,A1,951
A,Chile,3,4,2,5,-3,A2,951
A,Canada,3,2,2,3,-1,A3,951
A,Peru,3,1,1,5,-4,A4,951
B,Ecuador,3,7,9,3,6,B1,951
B,Mexico,3,6,8,5,3,B2,951
B,Venezuela,3,4,5,7,-2,B3,951
B,Jamaica,3,0,2,9,-7,B4,951
C,Uruguay,3,7,11,1,10,C1,951
C,United States,3,7,5,3,2,C2,951
C,Panama,3,3,2,6,-4,C3,951
C,Bolivia,3,0,3,11,-8,C4,951
D,Costa Rica,3,5,3,1,2,D1,951
D,Brazil,3,4,7,5,2,D2,951
D,Colombia,3,3,2,2,0,D3,951
D,Paraguay,3,2,2,6,-4,D4,951
A,Argentina,3,9,9,2,7,A1,952
A,Chile,3,4,3,3,0,A2,952
A,Peru,3,4,2,3,-1,A3,952
A,Canada,3,0,1,7,-6,A4,952
B,Mexico,3,7,3,1,2,B1,952
B,Jamaica,3,6,5,4,1,B2,952
B,Ecuador,3,2,2,3,-1,B3,952
B,Venezuela,3,1,2,4,-2,B4,952
C,United States,3,6,9,2,7,C1,952
C,Bolivia,3,5,3,2,1,C2,952
C,Panama,3,4,2,7,-5,C3,952
C,Uruguay,3,1,0,3,-3,C4,952
D,Brazil,3,7,4,0,4,D1,952
D,Colombia,3,5,2,0,2,D2,952
D,Paraguay,3,4,2,1,1,D3,952
D,Costa Rica,3,0,0,7,-7,D4,952
A,Argentina,3,6,6,3,3,A1,953
A,Chile,3,4,4,4,0,A2,953
A,Peru,3,4,3,5,-2,A3,953
A,Canada,3,2,3,4,-1,A4,953
B,Mexico,3,9,6,2,4,B1,953
B,Ecuador,3,4,6,3,3,B2,953
B,Venezuela,3,3,3,7,-4,B3,953
B,Jamaica,3,1,3,6,-3,B4,953
C,United States,3,9,10,2,8,C1,953
C,Uruguay,3,4,3,2,1,C2,953
C,Panama,3,2,1,2,-1,C3,953
C,Bolivia,3,1,2,10,-8,C4,953
D,Brazil,3,7,2,0,2,D1,953
D,Colombia,3,6,2,1,1,D2,953
D,Paraguay,3,2,0,1,-1,D3,953
D,Costa Rica,3,1,0,2,-2,D4,953
A,Peru,3,6,5,3,2,A1,954
A,Argentina,3,6,4,2,2,A2,954
A,Chile,3,4,3,4,-1,A3,954
A,Canada,3,1,1,4,-3,A4,954
B,Mexico,3,9,9,2,7,B1,954
B,Jamaica,3,6,6,4,2,B2,954
B,Ecuador,3,3,1,6,-5,B3,954
B,Venezuela,3,0,1,5,-4,B4,954
C,Uruguay,3,7,4,0,4,C1,954
C,Panama,3,5,5,3,2,C2,954
C,United States,3,4,4,4,0,C3,954
C,Bolivia,3,0,1,7,-6,C4,954
D,Brazil,3,6,4,3,1,D1,954
D,Costa Rica,3,5,5,4,1,D2,954
D,Colombia,3,2,3,4,-1,D3,954
D,Paraguay,3,2,1,2,-1,D4,954
A,Chile,3,6,4,6,-2,A1,955
A,Peru,3,5,6,2,4,A2,955
A,Argentina,3,4,4,3,1,A3,955
A,Canada,3,1,4,7,-3,A4,955
B,Ecuador,3,7,7,3,4,B1,955
B,Mexico,3,7,5,3,2,B2,955
B,Venezuela,3,3,1,2,-1,B3,955
B,Jamaica,3,0,2,7,-5,B4,955
C,United States,3,7,6,2,4,C1,955
C,Panama,3,6,3,4,-1,C2,955
C,Bolivia,3,2,2,3,-1,C3,955
C,Uruguay,3,1,1,3,-2,C4,955
D,Brazil,3,9,9,1,8,D1,955
D,Colombia,3,6,4,2,2,D2,955
D,Paraguay,3,3,2,5,-3,D3,955
D,Costa Rica,3,0,1,8,-7,D4,955
A,Argentina,3,5,4,3,1,A1,956
A,Peru,3,4,3,5,-2,A2,956
A,Chile,3,4,5,8,-3,A3,956
A,Canada,3,3,8,4,4,A4,956
B,Ecuador,3,9,8,2,6,B1,956
B,Mexico,3,6,10,6,4,B2,956
B,Jamaica,3,1,2,6,-4,B3,956
B,Venezuela,3,1,4,10,-6,B4,956
C,United States,3,9,6,2,4,C1,956
C,Bolivia,3,6,5,2,3,C2,956
C,Uruguay,3,3,4,4,0,C3,956
C,Panama,3,0,1,8,-7,C4,956
D,Paraguay,3,7,6,2,4,D1,956
D,Brazil,3,5,6,5,1,D2,956
D,Colombia,3,2,3,5,-2,D3,956
D,Costa Rica,3,1,2,5,-3,D4,956
A,Canada,3,6,3,2,1,A1,957
A,Peru,3,5,3,2,1,A2,957
A,Argentina,3,4,4,2,2,A3,957
A,Chile,3,1,2,6,-4,A4,957
B,Mexico,3,7,7,1,6,B1,957
B,Venezuela,3,4,3,4,-1,B2,957
B,Ecuador,3,3,2,2,0,B3,957
B,Jamaica,3,1,1,6,-5,B4,957
C,Bolivia,3,7,5,2,3,C1,957
C,Panama,3,6,7,7,0,C2,957
C,United States,3,4,5,5,0,C3,957
C,Uruguay,3,0,7,10,-3,C4,957
D,Colombia,3,9,5,2,3,D1,957
D,Brazil,3,6,6,2,4,D2,957
D,Costa Rica,3,3,4,7,-3,D3,957
D,Paraguay,3,0,2,6,-4,D4,957
A,Argentina,3,9,6,1,5,A1,958
A,Chile,3,4,4,4,0,A2,958
A,Canada,3,4,4,5,-1,A3,958
A,Peru,3,0,1,5,-4,A4,958
B,Ecuador,3,7,4,1,3,B1,958
B,Mexico,3,7,6,4,2,B2,958
B,Jamaica,3,3,3,4,-1,B3,958
B,Venezuela,3,0,2,6,-4,B4,958
C,United States,3,9,7,0,7,C1,958
C,Uruguay,3,4,7,2,5,C2,958
C,Panama,3,4,3,4,-1,C3,958
C,Bolivia,3,0,1,12,-11,C4,958
D,Colombia,3,6,3,3,0,D1,958
D,Costa Rica,3,4,2,2,0,D2,958
D,Paraguay,3,4,2,3,-1,D3,958
D,Brazil,3,3,3,2,1,D4,958
A,Peru,3,7,5,2,3,A1,959
A,Argentina,3,4,8,3,5,A2,959
A,Chile,3,4,3,4,-1,A3,959
A,Canada,3,1,0,7,-7,A4,959
B,Ecuador,3,6,6,5,1,B1,959
B,Jamaica,3,4,2,2,0,B2,959
B,Mexico,3,4,2,3,-1,B3,959
B,Venezuela,3,3,3,3,0,B4,959
C,Uruguay,3,9,7,4,3,C1,959
C,United States,3,6,6,3,3,C2,959
C,Bolivia,3,3,3,5,-2,C3,959
C,Panama,3,0,3,7,-4,C4,959
D,Brazil,3,9,8,1,7,D1,959
D,Paraguay,3,4,2,2,0,D2,959
D,Colombia,3,2,3,5,-2,D3,959
D,Costa Rica,3,1,3,8,-5,D4,959
A,Chile,3,7,7,3,4,A1,960
A,Argentina,3,7,4,1,3,A2,960
A,Peru,3,3,3,4,-1,A3,960
A,Canada,3,0,1,7,-6,A4,960
B,Ecuador,3,6,7,3,4,B1,960
B,Jamaica,3,4,3,3,0,B2,960
B,Mexico,3,4,4,5,-1,B3,960
B,Venezuela,3,3,2,5,-3,B4,960
C,United States,3,7,7,2,5,C1,960
C,Uruguay,3,4,3,3,0,C2,960
C,Bolivia,3,4,2,5,-3,C3,960
C,Panama,3,1,1,3,-2,C4,960
D,Paraguay,3,6,5,3,2,D1,960
D,Brazil,3,6,3,3,0,D2,960
D,Colombia,3,4,3,1,2,D3,960
D,Costa Rica,3,1,1,5,-4,D4,960
A,Argentina,3,6,3,2,1,A1,961
A,Chile,3,5,3,1,2,A2,961
A,Canada,3,4,5,3,2,A3,961
A,Peru,3,1,3,8,-5,A4,961
B,Mexico,3,7,3,0,3,B1,961
B,Ecuador,3,5,2,0,2,B2,961
B,Venezuela,3,4,4,4,0,B3,961
B,Jamaica,3,0,2,7,-5,B4,961
C,United States,3,9,6,1,5,C1,961
C,Uruguay,3,6,6,4,2,C2,961
C,Panama,3,3,2,4,-2,C3,961
C,Bolivia,3,0,1,6,-5,C4,961
D,Paraguay,3,6,5,3,2,D1,961
D,Colombia,3,4,5,4,1,D2,961
D,Brazil,3,4,3,3,0,D3,961
D,Costa Rica,3,3,3,6,-3,D4,961
A,Chile,3,9,7,1,6,A1,962
A,Peru,3,3,2,2,0,A2,962
A,Argentina,3,3,3,5,-2,A3,962
A,Canada,3,3,2,6,-4,A4,962
B,Jamaica,3,6,4,1,3,B1,962
B,Ecuador,3,5,3,2,1,B2,962
B,Mexico,3,4,3,3,0,B3,962
B,Venezuela,3,1,0,4,-4,B4,962
C,Uruguay,3,9,4,0,4,C1,962
C,Panama,3,4,6,4,2,C2,962
C,United States,3,4,4,3,1,C3,962
C,Bolivia,3,0,1,8,-7,C4,962
D,Paraguay,3,7,5,3,2,D1,962
D,Colombia,3,6,3,2,1,D2,962
D,Brazil,3,4,5,3,2,D3,962
D,Costa Rica,3,0,4,9,-5,D4,962
A,Peru,3,7,8,3,5,A1,963
A,Chile,3,5,4,3,1,A2,963
A,Argentina,3,3,3,6,-3,A3,963
A,Canada,3,1,4,7,-3,A4,963
B,Mexico,3,7,5,0,5,B1,963
B,Ecuador,3,3,0,0,0,B2,963
B,Venezuela,3,2,1,2,-1,B3,963
B,Jamaica,3,2,1,5,-4,B4,963
C,Uruguay,3,9,6,1,5,C1,963
C,United States,3,4,3,2,1,C2,963
C,Bolivia,3,2,3,4,-1,C3,963
C,Panama,3,1,2,7,-5,C4,963
D,Brazil,3,7,7,3,4,D1,963
D,Colombia,3,4,2,2,0,D2,963
D,Costa Rica,3,4,3,4,-1,D3,963
D,Paraguay,3,1,2,5,-3,D4,963
A,Argentina,3,7,6,1,5,A1,964
A,Canada,3,4,4,5,-1,A2,964
A,Chile,3,2,2,4,-2,A3,964
A,Peru,3,2,1,3,-2,A4,964
B,Venezuela,3,7,3,1,2,B1,964
B,Ecuador,3,4,4,3,1,B2,964
B,Mexico,3,3,5,5,0,B3,964
B,Jamaica,3,3,4,7,-3,B4,964
C,United States,3,6,7,4,3,C1,964
C,Panama,3,4,3,3,0,C2,964
C,Bolivia,3,4,4,6,-2,C3,964
C,Uruguay,3,3,3,4,-1,C4,964
D,Colombia,3,9,9,2,7,D1,964
D,Brazil,3,4,4,4,0,D2,964
D,Costa Rica,3,3,4,7,-3,D3,964
D,Paraguay,3,1,2,6,-4,D4,964
A,Chile,3,7,5,1,4,A1,965
A,Argentina,3,7,3,1,2,A2,965
A,Canada,3,3,3,6,-3,A3,965
A,Peru,3,0,2,5,-3,A4,965
B,Ecuador,3,9,5,0,5,B1,965
B,Mexico,3,6,5,1,4,B2,965
B,Jamaica,3,3,1,4,-3,B3,965
B,Venezuela,3,0,0,6,-6,B4,965
C,United States,3,7,6,1,5,C1,965
C,Uruguay,3,6,6,3,3,C2,965
C,Panama,3,2,1,4,-3,C3,965
C,Bolivia,3,1,0,5,-5,C4,965
D,Brazil,3,7,6,2,4,D1,965
D,Colombia,3,3,1,1,0,D2,965
D,Paraguay,3,2,2,3,-1,D3,965
D,Costa Rica,3,2,3,6,-3,D4,965
A,Argentina,3,7,8,2,6,A1,966
A,Canada,3,6,3,3,0,A2,966
A,Chile,3,2,3,4,-1,A3,966
A,Peru,3,1,2,7,-5,A4,966
B,Ecuador,3,6,3,2,1,B1,966
B,Mexico,3,5,4,3,1,B2,966
B,Venezuela,3,2,3,4,-1,B3,966
B,Jamaica,3,2,1,2,-1,B4,966
C,United States,3,9,9,3,6,C1,966
C,Uruguay,3,6,7,5,2,C2,966
C,Bolivia,3,3,3,5,-2,C3,966
C,Panama,3,0,2,8,-6,C4,966
D,Brazil,3,6,8,2,6,D1,966
D,Colombia,3,6,5,4,1,D2,966
D,Paraguay,3,4,4,7,-3,D3,966
D,Costa Rica,3,1,1,5,-4,D4,966
A,Argentina,3,7,8,1,7,A1,967
A,Peru,3,4,5,7,-2,A2,967
A,Chile,3,3,1,5,-4,A3,967
A,Canada,3,2,4,5,-1,A4,967
B,Mexico,3,7,6,4,2,B1,967
B,Jamaica,3,5,5,4,1,B2,967
B,Ecuador,3,3,5,4,1,B3,967
B,Venezuela,3,1,2,6,-4,B4,967
C,Uruguay,3,7,7,4,3,C1,967
C,United States,3,5,5,3,2,C2,967
C,Panama,3,2,3,5,-2,C3,967
C,Bolivia,3,1,4,7,-3,C4,967
D,Brazil,3,9,11,2,9,D1,967
D,Costa Rica,3,4,2,4,-2,D2,967
D,Colombia,3,2,2,4,-2,D3,967
D,Paraguay,3,1,2,7,-5,D4,967
A,Chile,3,5,4,1,3,A1,968
A,Peru,3,5,3,1,2,A2,968
A,Argentina,3,4,3,3,0,A3,968
A,Canada,3,1,0,5,-5,A4,968
B,Mexico,3,9,9,2,7,B1,968
B,Jamaica,3,4,2,3,-1,B2,968
B,Ecuador,3,3,2,4,-2,B3,968
B,Venezuela,3,1,2,6,-4,B4,968
C,Uruguay,3,7,6,1,5,C1,968
C,Panama,3,6,5,6,-1,C2,968
C,United States,3,2,2,3,-1,C3,968
C,Bolivia,3,1,4,7,-3,C4,968
D,Brazil,3,9,7,1,6,D1,968
D,Paraguay,3,4,4,4,0,D2,968
D,Colombia,3,4,1,2,-1,D3,968
D,Costa Rica,3,0,2,7,-5,D4,968
A,Argentina,3,5,4,3,1,A1,969
A,Chile,3,5,4,3,1,A2,969
A,Canada,3,3,2,3,-1,A3,969
A,Peru,3,2,3,4,-1,A4,969
B,Mexico,3,7,3,0,3,B1,969
B,Venezuela,3,6,5,4,1,B2,969
B,Jamaica,3,2,0,2,-2,B3,969
B,Ecuador,3,1,2,4,-2,B4,969
C,United States,3,7,8,3,5,C1,969
C,Uruguay,3,7,5,1,4,C2,969
C,Panama,3,1,3,6,-3,C3,969
C,Bolivia,3,1,3,9,-6,C4,969
D,Brazil,3,7,3,0,3,D1,969
D,Colombia,3,4,2,2,0,D2,969
D,Paraguay,3,4,2,3,-1,D3,969
D,Costa Rica,3,1,1,3,-2,D4,969
A,Canada,3,6,7,3,4,A1,970
A,Argentina,3,6,3,2,1,A2,970
A,Chile,3,3,4,6,-2,A3,970
A,Peru,3,3,3,6,-3,A4,970
B,Mexico,3,7,5,3,2,B1,970
B,Venezuela,3,3,2,2,0,B2,970
B,Ecuador,3,2,2,3,-1,B3,970
B,Jamaica,3,2,1,2,-1,B4,970
C,Panama,3,5,5,3,2,C1,970
C,United States,3,5,5,3,2,C2,970
C,Bolivia,3,3,1,4,-3,C3,970
C,Uruguay,3,2,2,3,-1,C4,970
D,Brazil,3,7,3,1,2,D1,970
D,Costa Rica,3,4,5,4,1,D2,970
D,Paraguay,3,3,4,4,0,D3,970
D,Colombia,3,1,4,7,-3,D4,970
A,Argentina,3,7,4,1,3,A1,971
A,Chile,3,4,3,2,1,A2,971
A,Peru,3,4,3,2,1,A3,971
A,Canada,3,1,2,7,-5,A4,971
B,Venezuela,3,9,8,2,6,B1,971
B,Ecuador,3,4,5,3,2,B2,971
B,Mexico,3,3,5,10,-5,B3,971
B,Jamaica,3,1,1,4,-3,B4,971
C,Uruguay,3,9,9,4,5,C1,971
C,Bolivia,3,4,4,4,0,C2,971
C,United States,3,3,2,3,-1,C3,971
C,Panama,3,1,4,8,-4,C4,971
D,Brazil,3,4,5,3,2,D1,971
D,Colombia,3,4,3,3,0,D2,971
D,Costa Rica,3,4,2,4,-2,D3,971
D,Paraguay,3,3,3,3,0,D4,971
A,Argentina,3,9,8,1,7,A1,972
A,Chile,3,4,3,4,-1,A2,972
A,Peru,3,4,3,4,-1,A3,972
A,Canada,3,0,0,5,-5,A4,972
B,Mexico,3,6,4,3,1,B1,972
B,Ecuador,3,4,6,6,0,B2,972
B,Venezuela,3,4,4,5,-1,B3,972
B,Jamaica,3,3,5,5,0,B4,972
C,United States,3,9,6,2,4,C1,972
C,Uruguay,3,6,6,4,2,C2,972
C,Panama,3,3,5,6,-1,C3,972
C,Bolivia,3,0,3,8,-5,C4,972
D,Colombia,3,7,6,0,6,D1,972
D,Brazil,3,7,3,0,3,D2,972
D,Paraguay,3,3,4,5,-1,D3,972
D,Costa Rica,3,0,1,9,-8,D4,972
A,Argentina,3,9,8,1,7,A1,973
A,Peru,3,6,4,5,-1,A2,973
A,Canada,3,3,8,4,4,A3,973
A,Chile,3,0,1,11,-10,A4,973
B,Venezuela,3,7,6,2,4,B1,973
B,Mexico,3,6,3,4,-1,B2,973
B,Ecuador,3,4,2,2,0,B3,973
B,Jamaica,3,0,2,5,-3,B4,973
C,Uruguay,3,7,5,2,3,C1,973
C,Bolivia,3,4,6,4,2,C2,973
C,United States,3,4,6,5,1,C3,973
C,Panama,3,1,2,8,-6,C4,973
D,Colombia,3,9,7,0,7,D1,973
D,Brazil,3,6,5,2,3,D2,973
D,Costa Rica,3,3,2,6,-4,D3,973
D,Paraguay,3,0,0,6,-6,D4,973
A,Argentina,3,7,5,1,4,A1,974
A,Peru,3,6,2,3,-1,A2,974
A,Canada,3,3,2,3,-1,A3,974
A,Chile,3,1,2,4,-2,A4,974
B,Mexico,3,7,10,1,9,B1,974
B,Venezuela,3,5,2,1,1,B2,974
B,Ecuador,3,3,3,7,-4,B3,974
B,Jamaica,3,1,1,7,-6,B4,974
C,United States,3,9,6,2,4,C1,974
C,Uruguay,3,6,5,4,1,C2,974
C,Bolivia,3,3,5,7,-2,C3,974
C,Panama,3,0,4,7,-3,C4,974
D,Brazil,3,7,6,3,3,D1,974
D,Colombia,3,7,4,1,3,D2,974
D,Paraguay,3,3,2,5,-3,D3,974
D,Costa Rica,3,0,1,4,-3,D4,974
A,Argentina,3,9,4,0,4,A1,975
A,Chile,3,4,5,5,0,A2,975
A,Canada,3,3,2,4,-2,A3,975
A,Peru,3,1,2,4,-2,A4,975
B,Mexico,3,7,3,1,2,B1,975
B,Jamaica,3,4,3,3,0,B2,975
B,Ecuador,3,3,3,3,0,B3,975
B,Venezuela,3,3,2,4,-2,B4,975
C,United States,3,9,7,4,3,C1,975
C,Uruguay,3,6,8,4,4,C2,975
C,Bolivia,3,3,4,7,-3,C3,975
C,Panama,3,0,1,5,-4,C4,975
D,Paraguay,3,5,3,2,1,D1,975
D,Costa Rica,3,4,3,3,0,D2,975
D,Brazil,3,3,2,2,0,D3,975
D,Colombia,3,2,4,5,-1,D4,975
A,Chile,3,9,5,1,4,A1,976
A,Argentina,3,6,4,2,2,A2,976
A,Peru,3,3,3,6,-3,A3,976
A,Canada,3,0,2,5,-3,A4,976
B,Ecuador,3,7,4,2,2,B1,976
B,Mexico,3,6,7,1,6,B2,976
B,Venezuela,3,4,5,7,-2,B3,976
B,Jamaica,3,0,2,8,-6,B4,976
C,Uruguay,3,9,6,2,4,C1,976
C,Bolivia,3,4,4,3,1,C2,976
C,United States,3,4,4,3,1,C3,976
C,Panama,3,0,0,6,-6,C4,976
D,Brazil,3,4,4,3,1,D1,976
D,Colombia,3,4,3,2,1,D2,976
D,Costa Rica,3,4,3,4,-1,D3,976
D,Paraguay,3,4,2,3,-1,D4,976
A,Argentina,3,6,8,5,3,A1,977
A,Peru,3,6,5,4,1,A2,977
A,Chile,3,6,3,2,1,A3,977
A,Canada,3,0,1,6,-5,A4,977
B,Mexico,3,6,6,5,1,B1,977
B,Venezuela,3,4,5,2,3,B2,977
B,Jamaica,3,4,1,4,-3,B3,977
B,Ecuador,3,2,2,3,-1,B4,977
C,Uruguay,3,9,6,0,6,C1,977
C,United States,3,6,6,5,1,C2,977
C,Bolivia,3,3,4,5,-1,C3,977
C,Panama,3,0,2,8,-6,C4,977
D,Brazil,3,7,9,1,8,D1,977
D,Colombia,3,7,5,0,5,D2,977
D,Paraguay,3,3,3,6,-3,D3,977
D,Costa Rica,3,0,1,11,-10,D4,977
A,Chile,3,4,5,4,1,A1,978
A,Argentina,3,4,4,4,0,A2,978
A,Canada,3,4,3,4,-1,A3,978
A,Peru,3,3,5,5,0,A4,978
B,Mexico,3,5,5,2,3,B1,978
B,Jamaica,3,4,1,3,-2,B2,978
B,Ecuador,3,3,1,1,0,B3,978
B,Venezuela,3,2,1,2,-1,B4,978
C,United States,3,7,8,0,8,C1,978
C,Uruguay,3,5,4,1,3,C2,978
C,Panama,3,4,3,6,-3,C3,978
C,Bolivia,3,0,1,9,-8,C4,978
D,Brazil,3,9,4,0,4,D1,978
D,Colombia,3,6,4,2,2,D2,978
D,Paraguay,3,3,1,2,-1,D3,978
D,Costa Rica,3,0,1,6,-5,D4,978
A,Argentina,3,7,4,0,4,A1,979
A,Peru,3,6,3,3,0,A2,979
A,Chile,3,3,1,2,-1,A3,979
A,Canada,3,1,0,3,-3,A4,979
B,Ecuador,3,6,8,6,2,B1,979
B,Mexico,3,6,6,4,2,B2,979
B,Venezuela,3,3,5,5,0,B3,979
B,Jamaica,3,3,3,7,-4,B4,979
C,Uruguay,3,7,7,2,5,C1,979
C,United States,3,5,4,1,3,C2,979
C,Panama,3,4,2,3,-1,C3,979
C,Bolivia,3,0,1,8,-7,C4,979
D,Brazil,3,7,4,0,4,D1,979
D,Colombia,3,4,1,2,-1,D2,979
D,Costa Rica,3,2,1,2,-1,D3,979
D,Paraguay,3,2,1,3,-2,D4,979
A,Argentina,3,9,7,2,5,A1,980
A,Chile,3,4,7,5,2,A2,980
A,Canada,3,2,3,6,-3,A3,980
A,Peru,3,1,1,5,-4,A4,980
B,Jamaica,3,7,4,2,2,B1,980
B,Venezuela,3,4,2,2,0,B2,980
B,Mexico,3,3,4,4,0,B3,980
B,Ecuador,3,1,3,5,-2,B4,980
C,United States,3,9,7,1,6,C1,980
C,Uruguay,3,4,5,3,2,C2,980
C,Bolivia,3,2,2,4,-2,C3,980
C,Panama,3,1,1,7,-6,C4,980
D,Costa Rica,3,7,4,2,2,D1,980
D,Colombia,3,5,2,1,1,D2,980
D,Brazil,3,3,6,6,0,D3,980
D,Paraguay,3,1,5,8,-3,D4,980
A,Chile,3,7,7,4,3,A1,981
A,Argentina,3,6,8,6,2,A2,981
A,Peru,3,4,6,4,2,A3,981
A,Canada,3,0,2,9,-7,A4,981
B,Ecuador,3,7,6,3,3,B1,981
B,Jamaica,3,4,4,2,2,B2,981
B,Venezuela,3,2,1,3,-2,B3,981
B,Mexico,3,2,3,6,-3,B4,981
C,United States,3,9,12,2,10,C1,981
C,Uruguay,3,6,8,4,4,C2,981
C,Panama,3,3,3,8,-5,C3,981
C,Bolivia,3,0,2,11,-9,C4,981
D,Brazil,3,5,5,3,2,D1,981
D,Colombia,3,5,5,3,2,D2,981
D,Paraguay,3,3,2,5,-3,D3,981
D,Costa Rica,3,2,3,4,-1,D4,981
A,Peru,3,9,4,0,4,A1,982
A,Argentina,3,6,6,4,2,A2,982
A,Chile,3,3,4,4,0,A3,982
A,Canada,3,0,3,9,-6,A4,982
B,Ecuador,3,5,6,3,3,B1,982
B,Venezuela,3,4,4,3,1,B2,982
B,Mexico,3,3,2,2,0,B3,982
B,Jamaica,3,2,3,7,-4,B4,982
C,Bolivia,3,6,4,4,0,C1,982
C,Uruguay,3,5,4,2,2,C2,982
C,United States,3,4,6,3,3,C3,982
C,Panama,3,1,2,7,-5,C4,982
D,Brazil,3,9,7,0,7,D1,982
D,Paraguay,3,4,1,1,0,D2,982
D,Colombia,3,3,3,3,0,D3,982
D,Costa Rica,3,1,1,8,-7,D4,982
A,Peru,3,6,3,1,2,A1,983
A,Argentina,3,4,3,3,0,A2,983
A,Canada,3,4,3,3,0,A3,983
A,Chile,3,3,2,4,-2,A4,983
B,Venezuela,3,7,4,1,3,B1,983
B,Ecuador,3,5,2,1,1,B2,983
B,Mexico,3,4,3,1,2,B3,983
B,Jamaica,3,0,0,6,-6,B4,983
C,United States,3,7,4,1,3,C1,983
C,Uruguay,3,6,5,1,4,C2,983
C,Panama,3,2,1,4,-3,C3,983
C,Bolivia,3,1,0,4,-4,C4,983
D,Brazil,3,6,3,2,1,D1,983
D,Costa Rica,3,4,4,4,0,D2,983
D,Colombia,3,4,3,3,0,D3,983
D,Paraguay,3,2,0,1,-1,D4,983
A,Chile,3,7,8,2,6,A1,984
A,Argentina,3,6,4,2,2,A2,984
A,Peru,3,2,3,4,-1,A3,984
A,Canada,3,1,2,9,-7,A4,984
B,Ecuador,3,6,3,2,1,B1,984
B,Jamaica,3,6,2,1,1,B2,984
B,Mexico,3,4,2,2,0,B3,984
B,Venezuela,3,1,2,4,-2,B4,984
C,Uruguay,3,7,5,0,5,C1,984
C,United States,3,4,4,1,3,C2,984
C,Bolivia,3,4,2,3,-1,C3,984
C,Panama,3,1,1,8,-7,C4,984
D,Colombia,3,5,4,3,1,D1,984
D,Brazil,3,5,3,2,1,D2,984
D,Paraguay,3,3,1,1,0,D3,984
D,Costa Rica,3,1,0,2,-2,D4,984
A,Argentina,3,7,6,2,4,A1,985
A,Peru,3,4,2,2,0,A2,985
A,Chile,3,3,3,4,-1,A3,985
A,Canada,3,3,2,5,-3,A4,985
B,Jamaica,3,5,7,5,2,B1,985
B,Mexico,3,5,4,3,1,B2,985
B,Venezuela,3,3,6,8,-2,B3,985
B,Ecuador,3,2,3,4,-1,B4,985
C,Uruguay,3,9,9,0,9,C1,985
C,United States,3,6,10,3,7,C2,985
C,Bolivia,3,3,2,7,-5,C3,985
C,Panama,3,0,1,12,-11,C4,985
D,Brazil,3,9,7,0,7,D1,985
D,Costa Rica,3,3,1,2,-1,D2,985
D,Colombia,3,3,3,5,-2,D3,985
D,Paraguay,3,3,2,6,-4,D4,985
A,Chile,3,7,4,1,3,A1,986
A,Argentina,3,4,4,3,1,A2,986
A,Peru,3,4,2,3,-1,A3,986
A,Canada,3,1,0,3,-3,A4,986
B,Mexico,3,6,6,3,3,B1,986
B,Venezuela,3,6,5,3,2,B2,986
B,Ecuador,3,4,5,5,0,B3,986
B,Jamaica,3,1,2,7,-5,B4,986
C,Uruguay,3,7,6,2,4,C1,986
C,Panama,3,6,6,5,1,C2,986
C,United States,3,3,5,5,0,C3,986
C,Bolivia,3,1,5,10,-5,C4,986
D,Paraguay,3,9,6,1,5,D1,986
D,Brazil,3,4,3,3,0,D2,986
D,Costa Rica,3,2,3,6,-3,D3,986
D,Colombia,3,1,2,4,-2,D4,986
A,Argentina,3,9,11,2,9,A1,987
A,Chile,3,4,4,6,-2,A2,987
A,Canada,3,3,2,7,-5,A3,987
A,Peru,3,1,1,3,-2,A4,987
B,Venezuela,3,6,8,2,6,B1,987
B,Mexico,3,4,3,2,1,B2,987
B,Ecuador,3,4,3,6,-3,B3,987
B,Jamaica,3,2,1,5,-4,B4,987
C,Uruguay,3,7,2,0,2,C1,987
C,United States,3,5,3,2,1,C2,987
C,Bolivia,3,3,3,4,-1,C3,987
C,Panama,3,1,4,6,-2,C4,987
D,Brazil,3,7,5,3,2,D1,987
D,Colombia,3,4,3,2,1,D2,987
D,Paraguay,3,3,2,3,-1,D3,987
D,Costa Rica,3,3,2,4,-2,D4,987
A,Argentina,3,7,5,2,3,A1,988
A,Canada,3,4,2,2,0,A2,988
A,Peru,3,2,2,3,-1,A3,988
A,Chile,3,2,3,5,-2,A4,988
B,Mexico,3,9,9,1,8,B1,988
B,Ecuador,3,6,6,5,1,B2,988
B,Venezuela,3,3,4,4,0,B3,988
B,Jamaica,3,0,0,9,-9,B4,988
C,Uruguay,3,7,5,2,3,C1,988
C,United States,3,6,10,3,7,C2,988
C,Panama,3,2,5,10,-5,C3,988
C,Bolivia,3,1,2,7,-5,C4,988
D,Brazil,3,7,7,1,6,D1,988
D,Colombia,3,7,3,0,3,D2,988
D,Paraguay,3,3,1,7,-6,D3,988
D,Costa Rica,3,0,1,4,-3,D4,988
A,Argentina,3,7,3,0,3,A1,989
A,Canada,3,3,1,1,0,A2,989
A,Chile,3,2,2,3,-1,A3,989
A,Peru,3,2,1,3,-2,A4,989
B,Ecuador,3,7,5,3,2,B1,989
B,Venezuela,3,5,4,3,1,B2,989
B,Mexico,3,4,6,5,1,B3,989
B,Jamaica,3,0,2,6,-4,B4,989
C,Uruguay,3,9,7,1,6,C1,989
C,United States,3,4,6,5,1,C2,989
C,Panama,3,3,3,7,-4,C3,989
C,Bolivia,3,1,3,6,-3,C4,989
D,Brazil,3,6,8,5,3,D1,989
D,Colombia,3,6,6,5,1,D2,989
D,Paraguay,3,4,2,3,-1,D3,989
D,Costa Rica,3,1,1,4,-3,D4,989
A,Peru,3,5,2,1,1,A1,990
A,Argentina,3,4,4,2,2,A2,990
A,Chile,3,4,3,3,0,A3,990
A,Canada,3,2,2,5,-3,A4,990
B,Ecuador,3,6,5,2,3,B1,990
B,Mexico,3,6,5,3,2,B2,990
B,Venezuela,3,6,5,5,0,B3,990
B,Jamaica,3,0,2,7,-5,B4,990
C,Uruguay,3,6,6,4,2,C1,990
C,Panama,3,5,5,2,3,C2,990
C,United States,3,4,10,7,3,C3,990
C,Bolivia,3,1,4,12,-8,C4,990
D,Brazil,3,7,7,2,5,D1,990
D,Colombia,3,5,3,1,2,D2,990
D,Costa Rica,3,4,2,3,-1,D3,990
D,Paraguay,3,0,2,8,-6,D4,990
A,Chile,3,9,5,1,4,A1,991
A,Argentina,3,6,5,1,4,A2,991
A,Peru,3,3,1,5,-4,A3,991
A,Canada,3,0,1,5,-4,A4,991
B,Ecuador,3,7,6,4,2,B1,991
B,Jamaica,3,7,5,3,2,B2,991
B,Mexico,3,3,2,3,-1,B3,991
B,Venezuela,3,0,2,5,-3,B4,991
C,Uruguay,3,7,6,2,4,C1,991
C,United States,3,6,8,3,5,C2,991
C,Panama,3,4,4,5,-1,C3,991
C,Bolivia,3,0,0,8,-8,C4,991
D,Brazil,3,7,9,1,8,D1,991
D,Paraguay,3,4,5,6,-1,D2,991
D,Costa Rica,3,3,1,7,-6,D3,991
D,Colombia,3,2,1,2,-1,D4,991
A,Argentina,3,9,10,0,10,A1,992
A,Canada,3,4,3,6,-3,A2,992
A,Chile,3,3,2,6,-4,A3,992
A,Peru,3,1,1,4,-3,A4,992
B,Ecuador,3,7,5,1,4,B1,992
B,Venezuela,3,4,6,6,0,B2,992
B,Mexico,3,3,5,5,0,B3,992
B,Jamaica,3,3,3,7,-4,B4,992
C,Uruguay,3,7,4,0,4,C1,992
C,United States,3,4,3,2,1,C2,992
C,Bolivia,3,4,3,5,-2,C3,992
C,Panama,3,1,2,5,-3,C4,992
D,Costa Rica,3,7,4,1,3,D1,992
D,Brazil,3,5,5,2,3,D2,992
D,Paraguay,3,4,3,4,-1,D3,992
D,Colombia,3,0,1,6,-5,D4,992
A,Chile,3,6,4,1,3,A1,993
A,Argentina,3,6,7,6,1,A2,993
A,Canada,3,3,5,7,-2,A3,993
A,Peru,3,3,3,5,-2,A4,993
B,Mexico,3,9,7,1,6,B1,993
B,Venezuela,3,4,4,5,-1,B2,993
B,Ecuador,3,3,4,6,-2,B3,993
B,Jamaica,3,1,2,5,-3,B4,993
C,Uruguay,3,9,8,1,7,C1,993
C,United States,3,4,6,6,0,C2,993
C,Panama,3,3,2,6,-4,C3,993
C,Bolivia,3,1,3,6,-3,C4,993
D,Paraguay,3,5,3,1,2,D1,993
D,Brazil,3,4,5,2,3,D2,993
D,Colombia,3,4,3,4,-1,D3,993
D,Costa Rica,3,3,1,5,-4,D4,993
A,Argentina,3,7,6,1,5,A1,994
A,Chile,3,7,3,0,3,A2,994
A,Peru,3,3,2,6,-4,A3,994
A,Canada,3,0,0,4,-4,A4,994
B,Venezuela,3,7,4,2,2,B1,994
B,Mexico,3,4,4,2,2,B2,994
B,Jamaica,3,3,2,5,-3,B3,994
B,Ecuador,3,2,4,5,-1,B4,994
C,Uruguay,3,7,8,4,4,C1,994
C,Bolivia,3,5,4,2,2,C2,994
C,United States,3,2,2,5,-3,C3,994
C,Panama,3,1,2,5,-3,C4,994
D,Brazil,3,7,5,1,4,D1,994
D,Paraguay,3,7,3,0,3,D2,994
D,Costa Rica,3,3,1,5,-4,D3,994
D,Colombia,3,0,1,4,-3,D4,994
A,Argentina,3,9,7,0,7,A1,995
A,Chile,3,4,5,5,0,A2,995
A,Peru,3,2,2,3,-1,A3,995
A,Canada,3,1,3,9,-6,A4,995
B,Jamaica,3,6,3,2,1,B1,995
B,Mexico,3,4,4,3,1,B2,995
B,Ecuador,3,4,5,5,0,B3,995
B,Venezuela,3,3,5,7,-2,B4,995
C,United States,3,9,7,1,6,C1,995
C,Uruguay,3,6,4,5,-1,C2,995
C,Bolivia,3,3,3,5,-2,C3,995
C,Panama,3,0,1,4,-3,C4,995
D,Brazil,3,9,4,0,4,D1,995
D,Colombia,3,4,4,3,1,D2,995
D,Costa Rica,3,4,2,3,-1,D3,995
D,Paraguay,3,0,1,5,-4,D4,995
A,Canada,3,7,4,2,2,A1,996
A,Argentina,3,6,5,3,2,A2,996
A,Peru,3,2,2,3,-1,A3,996
A,Chile,3,1,2,5,-3,A4,996
B,Ecuador,3,7,7,2,5,B1,996
B,Venezuela,3,4,3,3,0,B2,996
B,Mexico,3,2,3,4,-1,B3,996
B,Jamaica,3,2,1,5,-4,B4,996
C,United States,3,7,4,1,3,C1,996
C,Uruguay,3,6,7,4,3,C2,996
C,Panama,3,3,1,5,-4,C3,996
C,Bolivia,3,1,3,5,-2,C4,996
D,Brazil,3,9,9,1,8,D1,996
D,Colombia,3,6,5,2,3,D2,996
D,Costa Rica,3,1,1,4,-3,D3,996
D,Paraguay,3,1,0,8,-8,D4,996
A,Argentina,3,5,3,2,1,A1,997
A,Chile,3,4,3,3,0,A2,997
A,Canada,3,4,2,2,0,A3,997
A,Peru,3,2,3,4,-1,A4,997
B,Venezuela,3,6,5,3,2,B1,997
B,Mexico,3,4,4,2,2,B2,997
B,Jamaica,3,4,3,3,0,B3,997
B,Ecuador,3,3,3,7,-4,B4,997
C,Uruguay,3,7,9,3,6,C1,997
C,United States,3,5,6,3,3,C2,997
C,Bolivia,3,3,5,7,-2,C3,997
C,Panama,3,1,0,7,-7,C4,997
D,Brazil,3,7,4,1,3,D1,997
D,Colombia,3,7,5,3,2,D2,997
D,Costa Rica,3,3,3,5,-2,D3,997
D,Paraguay,3,0,2,5,-3,D4,997
A,Argentina,3,7,4,2,2,A1,998
A,Canada,3,4,4,3,1,A2,998
A,Peru,3,4,2,2,0,A3,998
A,Chile,3,1,3,6,-3,A4,998
B,Ecuador,3,5,4,1,3,B1,998
B,Mexico,3,4,5,4,1,B2,998
B,Venezuela,3,4,2,2,0,B3,998
B,Jamaica,3,3,4,8,-4,B4,998
C,Uruguay,3,6,8,3,5,C1,998
C,United States,3,6,5,2,3,C2,998
C,Panama,3,3,4,6,-2,C3,998
C,Bolivia,3,3,4,10,-6,C4,998
D,Brazil,3,6,6,1,5,D1,998
D,Colombia,3,6,4,3,1,D2,998
D,Costa Rica,3,3,4,6,-2,D3,998
D,Paraguay,3,3,1,5,-4,D4,998
A,Argentina,3,9,6,2,4,A1,999
A,Canada,3,2,2,3,-1,A2,999
A,Peru,3,2,0,1,-1,A3,999
A,Chile,3,2,0,2,-2,A4,999
B,Ecuador,3,9,5,1,4,B1,999
B,Mexico,3,6,4,4,0,B2,999
B,Venezuela,3,3,4,3,1,B3,999
B,Jamaica,3,0,2,7,-5,B4,999
C,Uruguay,3,7,6,2,4,C1,999
C,United States,3,4,7,6,1,C2,999
C,Panama,3,2,2,4,-2,C3,999
C,Bolivia,3,2,3,6,-3,C4,999
D,Colombia,3,9,11,2,9,D1,999
D,Brazil,3,4,6,3,3,D2,999
D,Paraguay,3,2,0,2,-2,D3,999
D,Costa Rica,3,1,0,10,-10,D4,999
A,Argentina,3,9,6,1,5,A1,1000
A,Peru,3,4,4,4,0,A2,1000
A,Chile,3,3,3,5,-2,A3,1000
A,Canada,3,1,1,4,-3,A4,1000
B,Mexico,3,6,5,4,1,B1,1000
B,Venezuela,3,4,6,4,2,B2,1000
B,Ecuador,3,4,2,4,-2,B3,1000
B,Jamaica,3,2,1,2,-1,B4,1000
C,Bolivia,3,6,4,5,-1,C1,1000
C,Panama,3,4,5,3,2,C2,1000
C,Uruguay,3,4,4,4,0,C3,1000
C,United States,3,2,1,2,-1,C4,1000
D,Brazil,3,7,5,0,5,D1,1000
D,Paraguay,3,4,1,4,-3,D2,1000
D,Colombia,3,2,0,1,-1,D3,1000
D,Costa Rica,3,2,0,1,-1,D4,1000
